,name,reference_name,HOM_ALT,HAS_ALT,N_SITES,F,transitions,transversions,titv
1,LP6005441-DNA_A01,1,76575,194216,194216,0.39428,133911,60305,2.220562142
2,LP6005441-DNA_A01,10,48418,124678,124678,0.38834,85782,38896,2.20541958
3,LP6005441-DNA_A01,11,53786,126109,126109,0.4265,85811,40298,2.129410889
4,LP6005441-DNA_A01,12,45056,116862,116862,0.38555,80299,36563,2.196181933
5,LP6005441-DNA_A01,13,43382,97987,97987,0.44273,67023,30964,2.164545924
6,LP6005441-DNA_A01,14,33631,81855,81855,0.41086,56137,25718,2.182790264
7,LP6005441-DNA_A01,15,28309,74230,74230,0.38137,50628,23602,2.145072451
8,LP6005441-DNA_A01,16,26898,75013,75013,0.35858,49155,25858,1.900959084
9,LP6005441-DNA_A01,17,24069,63833,63833,0.37706,45140,18693,2.414807682
10,LP6005441-DNA_A01,18,32794,74599,74599,0.4396,51092,23507,2.17348024
11,LP6005441-DNA_A01,19,15270,44106,44106,0.34621,31068,13038,2.38288081
12,LP6005441-DNA_A01,2,83464,216484,216484,0.38554,147363,69121,2.131957003
13,LP6005441-DNA_A01,20,18958,53573,53573,0.35387,37383,16190,2.309017912
14,LP6005441-DNA_A01,21,13565,35406,35406,0.38313,24164,11242,2.149439601
15,LP6005441-DNA_A01,22,11091,28913,28913,0.3836,20476,8437,2.426929003
16,LP6005441-DNA_A01,3,66196,183310,183310,0.36112,123644,59666,2.072268964
17,LP6005441-DNA_A01,4,78404,193264,193264,0.40568,130683,62581,2.088221665
18,LP6005441-DNA_A01,5,61118,158878,158878,0.38469,107409,51469,2.086867823
19,LP6005441-DNA_A01,6,59949,163500,163500,0.36666,112131,51369,2.182853472
20,LP6005441-DNA_A01,7,52190,137027,137027,0.38087,93341,43686,2.136634162
21,LP6005441-DNA_A01,8,52405,137461,137461,0.38124,91080,46381,1.96373515
22,LP6005441-DNA_A01,9,40125,107153,107153,0.37446,71617,35536,2.01533656
23,LP6005441-DNA_A01,MT,37,40,40,0.925,37,3,12.33333333
24,LP6005441-DNA_A01,X,47497,48344,48344,0.98248,32623,15721,2.075122448
25,LP6005441-DNA_A01,Y,403,434,434,0.92857,273,161,1.695652174
26,LP6005441-DNA_A03,1,92986,190792,190792,0.48737,131645,59147,2.225725734
27,LP6005441-DNA_A03,10,55864,123948,123948,0.45071,85473,38475,2.221520468
28,LP6005441-DNA_A03,11,60280,118171,118171,0.51011,79944,38227,2.091296727
29,LP6005441-DNA_A03,12,56505,118691,118691,0.47607,81603,37088,2.200253451
30,LP6005441-DNA_A03,13,45414,98337,98337,0.46182,66923,31414,2.130355892
31,LP6005441-DNA_A03,14,39634,81126,81126,0.48855,55289,25837,2.139915625
32,LP6005441-DNA_A03,15,33111,71249,71249,0.46472,48326,22923,2.108188283
33,LP6005441-DNA_A03,16,35801,71320,71320,0.50198,46957,24363,1.927389895
34,LP6005441-DNA_A03,17,27540,58692,58692,0.46923,41515,17177,2.416894685
35,LP6005441-DNA_A03,18,35636,74752,74752,0.47672,51208,23544,2.174991505
36,LP6005441-DNA_A03,19,18259,43108,43108,0.42356,30230,12878,2.347414195
37,LP6005441-DNA_A03,2,97461,209148,209148,0.46599,141878,67270,2.109082801
38,LP6005441-DNA_A03,20,23217,55825,55825,0.41589,38878,16947,2.29409335
39,LP6005441-DNA_A03,21,16225,36259,36259,0.44748,24857,11402,2.180056131
40,LP6005441-DNA_A03,22,12730,27703,27703,0.45952,19536,8167,2.39206563
41,LP6005441-DNA_A03,3,82678,186565,186565,0.44316,126292,60273,2.095332902
42,LP6005441-DNA_A03,4,89982,185733,185733,0.48447,125570,60163,2.087163207
43,LP6005441-DNA_A03,5,68749,153313,153313,0.44842,103354,49959,2.068776397
44,LP6005441-DNA_A03,6,70763,160400,160400,0.44117,110034,50366,2.184688083
45,LP6005441-DNA_A03,7,61442,135946,135946,0.45196,92407,43539,2.122396013
46,LP6005441-DNA_A03,8,61371,136597,136597,0.44929,90338,46259,1.952874035
47,LP6005441-DNA_A03,9,48479,105569,105569,0.45922,70501,35068,2.010408349
48,LP6005441-DNA_A03,MT,39,41,41,0.95122,NA,NA,NA
49,LP6005441-DNA_A03,X,34853,70433,70433,0.49484,47467,22966,2.066837934
50,LP6005441-DNA_A04,1,93047,189436,189436,0.49118,130574,58862,2.218307227
51,LP6005441-DNA_A04,10,57361,121745,121745,0.47116,83625,38120,2.193730325
52,LP6005441-DNA_A04,11,64970,119583,119583,0.5433,81041,38542,2.10266722
53,LP6005441-DNA_A04,12,66293,101085,101085,0.65581,69610,31475,2.211596505
54,LP6005441-DNA_A04,13,49078,95185,95185,0.51561,64959,30226,2.149110038
55,LP6005441-DNA_A04,14,44091,70962,70962,0.62133,48516,22446,2.161454157
56,LP6005441-DNA_A04,15,33191,69584,69584,0.47699,47458,22126,2.144897406
57,LP6005441-DNA_A04,16,35562,66970,66970,0.53101,43751,23219,1.884275809
58,LP6005441-DNA_A04,17,27094,57750,57750,0.46916,40723,17027,2.39167205
59,LP6005441-DNA_A04,18,35416,70740,70740,0.50065,48530,22210,2.185051778
60,LP6005441-DNA_A04,19,17858,41074,41074,0.43478,28912,12162,2.377240585
61,LP6005441-DNA_A04,2,104635,201797,201797,0.51852,137209,64588,2.124372949
62,LP6005441-DNA_A04,20,24535,50574,50574,0.48513,35131,15443,2.274881823
63,LP6005441-DNA_A04,21,17247,32513,32513,0.53046,22172,10341,2.144086645
64,LP6005441-DNA_A04,22,13899,26983,26983,0.5151,19189,7794,2.462022068
65,LP6005441-DNA_A04,3,96341,167683,167683,0.57454,113401,54282,2.089108728
66,LP6005441-DNA_A04,4,91948,180627,180627,0.50905,122139,58488,2.088274518
67,LP6005441-DNA_A04,5,70714,148608,148608,0.47584,100285,48323,2.075305755
68,LP6005441-DNA_A04,6,81961,153162,153162,0.53513,104843,48319,2.169808978
69,LP6005441-DNA_A04,7,67399,126350,126350,0.53343,86221,40129,2.148595779
70,LP6005441-DNA_A04,8,61315,131134,131134,0.46758,86869,44265,1.962475997
71,LP6005441-DNA_A04,9,51020,99117,99117,0.51475,66254,32863,2.016066701
72,LP6005441-DNA_A04,MT,34,37,37,0.91892,36,1,36
73,LP6005441-DNA_A04,X,35549,64858,64858,0.54811,43700,21158,2.06541261
74,LP6005441-DNA_A05,1,79964,186548,186548,0.42865,128329,58219,2.204246037
75,LP6005441-DNA_A05,10,49371,122278,122278,0.40376,84362,37916,2.224970989
76,LP6005441-DNA_A05,11,50401,124924,124924,0.40345,84683,40241,2.104396014
77,LP6005441-DNA_A05,12,45611,118681,118681,0.38432,81679,37002,2.20742122
78,LP6005441-DNA_A05,13,44468,98963,98963,0.44934,67518,31445,2.147177612
79,LP6005441-DNA_A05,14,30166,78925,78925,0.38221,54098,24827,2.178998671
80,LP6005441-DNA_A05,15,32276,67299,67299,0.47959,45628,21671,2.105486595
81,LP6005441-DNA_A05,16,28399,72850,72850,0.38983,47876,24974,1.917033715
82,LP6005441-DNA_A05,17,22217,62128,62128,0.3576,43959,18169,2.419450713
83,LP6005441-DNA_A05,18,31005,71625,71625,0.43288,49074,22551,2.176134096
84,LP6005441-DNA_A05,19,23039,36610,36610,0.62931,25803,10807,2.387619136
85,LP6005441-DNA_A05,2,80082,206231,206231,0.38831,140455,65776,2.13535332
86,LP6005441-DNA_A05,20,19921,52502,52502,0.37943,36642,15860,2.310340479
87,LP6005441-DNA_A05,21,13701,34742,34742,0.39436,23795,10947,2.173654883
88,LP6005441-DNA_A05,22,10576,28041,28041,0.37716,19791,8250,2.398909091
89,LP6005441-DNA_A05,3,71087,175344,175344,0.40541,118531,56813,2.086335874
90,LP6005441-DNA_A05,4,83059,180625,180625,0.45984,122082,58543,2.085338982
91,LP6005441-DNA_A05,5,58478,154251,154251,0.37911,104375,49876,2.092689871
92,LP6005441-DNA_A05,6,58879,161875,161875,0.36373,110752,51123,2.166383037
93,LP6005441-DNA_A05,7,52283,135295,135295,0.38644,92012,43283,2.125823071
94,LP6005441-DNA_A05,8,48922,136293,136293,0.35895,90585,45708,1.981819375
95,LP6005441-DNA_A05,9,40101,103693,103693,0.38673,69409,34284,2.024530393
96,LP6005441-DNA_A05,MT,12,16,16,0.75,15,1,15
97,LP6005441-DNA_A05,X,50069,50716,50716,0.98724,34076,16640,2.047836538
98,LP6005441-DNA_A05,Y,668,702,702,0.95157,432,270,1.6
99,LP6005441-DNA_A06,1,81364,193683,193683,0.42009,133408,60275,2.213322273
100,LP6005441-DNA_A06,10,52697,128096,128096,0.41139,88321,39775,2.220515399
101,LP6005441-DNA_A06,11,52207,128136,128136,0.40743,87108,41028,2.12313542
102,LP6005441-DNA_A06,12,46442,120375,120375,0.38581,82776,37599,2.201547914
103,LP6005441-DNA_A06,13,43353,100435,100435,0.43165,68569,31866,2.151791878
104,LP6005441-DNA_A06,14,33085,82395,82395,0.40154,56289,26106,2.156170995
105,LP6005441-DNA_A06,15,30138,75227,75227,0.40063,51192,24035,2.129893905
106,LP6005441-DNA_A06,16,29004,77085,77085,0.37626,50707,26378,1.922321632
107,LP6005441-DNA_A06,17,24209,63554,63554,0.38092,44872,18682,2.401884167
108,LP6005441-DNA_A06,18,28376,75796,75796,0.37437,52124,23672,2.201926326
109,LP6005441-DNA_A06,19,16019,44652,44652,0.35875,31480,13172,2.389918008
110,LP6005441-DNA_A06,2,83733,213905,213905,0.39145,145583,68322,2.130836334
111,LP6005441-DNA_A06,20,19392,53575,53575,0.36196,37388,16187,2.309754741
112,LP6005441-DNA_A06,21,14559,36478,36478,0.39912,24968,11510,2.169244136
113,LP6005441-DNA_A06,22,10052,29201,29201,0.34423,20767,8434,2.462295471
114,LP6005441-DNA_A06,3,70399,184051,184051,0.3825,124598,59453,2.095739492
115,LP6005441-DNA_A06,4,75221,187370,187370,0.40146,126841,60529,2.09554098
116,LP6005441-DNA_A06,5,59909,160498,160498,0.37327,108323,52175,2.07614758
117,LP6005441-DNA_A06,6,56979,160401,160401,0.35523,110141,50260,2.191424592
118,LP6005441-DNA_A06,7,50987,138543,138543,0.36802,94403,44140,2.138717716
119,LP6005441-DNA_A06,8,51043,141469,141469,0.36081,93783,47686,1.966677851
120,LP6005441-DNA_A06,9,41456,107671,107671,0.38502,72156,35515,2.031704913
121,LP6005441-DNA_A06,MT,15,17,17,0.88235,15,2,7.5
122,LP6005441-DNA_A06,X,49373,49986,49986,0.98774,33554,16432,2.041991237
123,LP6005441-DNA_A06,Y,687,721,721,0.95284,457,264,1.731060606
124,LP6005441-DNA_A08,1,88282,241810,241810,0.36509,166884,74926,2.22731762
125,LP6005441-DNA_A08,10,57409,156474,156474,0.36689,107443,49031,2.191327935
126,LP6005441-DNA_A08,11,56332,154630,154630,0.3643,105242,49388,2.130922491
127,LP6005441-DNA_A08,12,62711,150629,150629,0.41633,103521,47108,2.197524837
128,LP6005441-DNA_A08,13,43504,119830,119830,0.36305,81487,38343,2.125211903
129,LP6005441-DNA_A08,14,38535,102177,102177,0.37714,69710,32467,2.147103212
130,LP6005441-DNA_A08,15,33805,91713,91713,0.3686,62520,29193,2.14160929
131,LP6005441-DNA_A08,16,33420,94328,94328,0.3543,61846,32482,1.904008374
132,LP6005441-DNA_A08,17,27315,77595,77595,0.35202,54799,22796,2.403886647
133,LP6005441-DNA_A08,18,33173,94569,94569,0.35078,64762,29807,2.172711108
134,LP6005441-DNA_A08,19,22723,56608,56608,0.40141,39651,16957,2.338326355
135,LP6005441-DNA_A08,2,100927,274176,274176,0.36811,185827,88349,2.103328844
136,LP6005441-DNA_A08,20,26520,70849,70849,0.37432,49446,21403,2.310236883
137,LP6005441-DNA_A08,21,18830,47479,47479,0.3966,32452,15027,2.159579424
138,LP6005441-DNA_A08,22,13666,38170,38170,0.35803,26994,11176,2.415354331
139,LP6005441-DNA_A08,3,83755,233469,233469,0.35874,157534,75935,2.07459011
140,LP6005441-DNA_A08,4,92690,234062,234062,0.39601,158214,75848,2.085935028
141,LP6005441-DNA_A08,5,74516,206651,206651,0.36059,139855,66796,2.0937631
142,LP6005441-DNA_A08,6,74154,202088,202088,0.36694,138478,63610,2.176984751
143,LP6005441-DNA_A08,7,65688,180466,180466,0.36399,122185,58281,2.096480843
144,LP6005441-DNA_A08,8,68425,185395,185395,0.36908,122572,62823,1.951068876
145,LP6005441-DNA_A08,9,49074,138508,138508,0.3543,92628,45880,2.018918919
146,LP6005441-DNA_A08,MT,83,89,89,0.93258,85,4,21.25
147,LP6005441-DNA_A08,X,80017,81244,81244,0.9849,54366,26878,2.022695141
148,LP6005441-DNA_A08,Y,1247,1286,1286,0.96967,781,505,1.546534653
149,LP6005441-DNA_A10,1,93987,176136,176136,0.5336,121161,54975,2.203929059
150,LP6005441-DNA_A10,10,57201,113114,113114,0.50569,77664,35450,2.190803949
151,LP6005441-DNA_A10,11,57667,113761,113761,0.50691,77058,36703,2.099501403
152,LP6005441-DNA_A10,12,56044,111118,111118,0.50436,76158,34960,2.178432494
153,LP6005441-DNA_A10,13,49408,88847,88847,0.5561,60390,28457,2.122149208
154,LP6005441-DNA_A10,14,36211,76419,76419,0.47385,52302,24117,2.168677696
155,LP6005441-DNA_A10,15,31308,67609,67609,0.46307,45896,21713,2.113756736
156,LP6005441-DNA_A10,16,31773,66998,66998,0.47424,43954,23044,1.90739455
157,LP6005441-DNA_A10,17,25114,54649,54649,0.45955,38343,16306,2.351465718
158,LP6005441-DNA_A10,18,36208,69158,69158,0.52355,47168,21990,2.144974989
159,LP6005441-DNA_A10,19,16389,37310,37310,0.43927,26107,11203,2.33035794
160,LP6005441-DNA_A10,2,104810,187551,187551,0.55883,127015,60536,2.098172988
161,LP6005441-DNA_A10,20,22337,47979,47979,0.46556,33403,14576,2.291643798
162,LP6005441-DNA_A10,21,17159,33929,33929,0.50573,23039,10890,2.115610652
163,LP6005441-DNA_A10,22,11782,24237,24237,0.48612,17107,7130,2.399298738
164,LP6005441-DNA_A10,3,84438,177044,177044,0.47693,119367,57677,2.069577128
165,LP6005441-DNA_A10,4,92298,171890,171890,0.53696,115810,56080,2.065085592
166,LP6005441-DNA_A10,5,68350,146493,146493,0.46658,98730,47763,2.067081213
167,LP6005441-DNA_A10,6,73721,156004,156004,0.47256,106570,49434,2.155803698
168,LP6005441-DNA_A10,7,62084,125983,125983,0.4928,85591,40392,2.119008715
169,LP6005441-DNA_A10,8,65347,124027,124027,0.52688,82134,41893,1.960566204
170,LP6005441-DNA_A10,9,49218,95594,95594,0.51486,63703,31891,1.997522812
171,LP6005441-DNA_A10,MT,39,41,41,0.95122,40,1,40
172,LP6005441-DNA_A10,X,52322,55095,55095,0.94967,35945,19150,1.877023499
173,LP6005441-DNA_A10,Y,620,794,794,0.78086,412,382,1.078534031
174,LP6005441-DNA_A11,1,90763,237395,237395,0.38233,163882,73513,2.229292778
175,LP6005441-DNA_A11,10,57574,157184,157184,0.36628,108036,49148,2.198176935
176,LP6005441-DNA_A11,11,56241,153158,153158,0.36721,104248,48910,2.131425066
177,LP6005441-DNA_A11,12,52114,145766,145766,0.35752,100031,45735,2.187187056
178,LP6005441-DNA_A11,13,43321,121507,121507,0.35653,82559,38948,2.119723734
179,LP6005441-DNA_A11,14,40189,104761,104761,0.38363,71678,33083,2.16661125
180,LP6005441-DNA_A11,15,32639,92025,92025,0.35468,62373,29652,2.103500607
181,LP6005441-DNA_A11,16,34973,93564,93564,0.37379,61429,32135,1.911591722
182,LP6005441-DNA_A11,17,28048,77296,77296,0.36286,54295,23001,2.360549541
183,LP6005441-DNA_A11,18,33414,93588,93588,0.35703,63761,29827,2.137694036
184,LP6005441-DNA_A11,19,20052,56121,56121,0.3573,39521,16600,2.380783133
185,LP6005441-DNA_A11,2,99734,272238,272238,0.36635,184536,87702,2.104125334
186,LP6005441-DNA_A11,20,26786,72408,72408,0.36993,50445,21963,2.296817375
187,LP6005441-DNA_A11,21,17373,47172,47172,0.36829,32292,14880,2.17016129
188,LP6005441-DNA_A11,22,14161,35533,35533,0.39853,25175,10358,2.430488511
189,LP6005441-DNA_A11,3,89178,235134,235134,0.37926,158733,76401,2.077629874
190,LP6005441-DNA_A11,4,89799,234431,234431,0.38305,158065,76366,2.069834743
191,LP6005441-DNA_A11,5,79991,206334,206334,0.38768,139439,66895,2.084445773
192,LP6005441-DNA_A11,6,71541,206148,206148,0.34704,141066,65082,2.167511754
193,LP6005441-DNA_A11,7,67463,178313,178313,0.37834,121015,57298,2.112028343
194,LP6005441-DNA_A11,8,67972,184714,184714,0.36799,122531,62183,1.970490327
195,LP6005441-DNA_A11,9,51952,139147,139147,0.37336,93084,46063,2.020797603
196,LP6005441-DNA_A11,MT,87,88,88,0.98864,83,5,16.6
197,LP6005441-DNA_A11,X,81942,84441,84441,0.97041,55796,28645,1.947844301
198,LP6005441-DNA_A11,Y,1267,1449,1449,0.8744,840,609,1.379310345
199,LP6005441-DNA_A12,1,103980,180274,180274,0.57679,124344,55930,2.223207581
200,LP6005441-DNA_A12,10,63597,117521,117521,0.54115,80555,36966,2.179164638
201,LP6005441-DNA_A12,11,59870,123317,123317,0.4855,83451,39866,2.093287513
202,LP6005441-DNA_A12,12,63746,107120,107120,0.59509,73508,33612,2.186957039
203,LP6005441-DNA_A12,13,63926,85354,85354,0.74895,57955,27399,2.115223183
204,LP6005441-DNA_A12,14,38843,77156,77156,0.50343,52522,24634,2.132093854
205,LP6005441-DNA_A12,15,38426,70160,70160,0.54769,47824,22336,2.141117479
206,LP6005441-DNA_A12,16,33666,68630,68630,0.49054,44903,23727,1.892485354
207,LP6005441-DNA_A12,17,28854,55200,55200,0.52272,38727,16473,2.350937898
208,LP6005441-DNA_A12,18,35314,75011,75011,0.47078,51326,23685,2.167025544
209,LP6005441-DNA_A12,19,24856,34596,34596,0.71846,24207,10389,2.330060641
210,LP6005441-DNA_A12,2,101527,209428,209428,0.48478,142108,67320,2.110932858
211,LP6005441-DNA_A12,20,26090,47787,47787,0.54596,33521,14266,2.349712603
212,LP6005441-DNA_A12,21,16840,33544,33544,0.50203,22988,10556,2.177718833
213,LP6005441-DNA_A12,22,13093,27834,27834,0.4704,19701,8133,2.422353375
214,LP6005441-DNA_A12,3,88427,176077,176077,0.50221,118803,57274,2.074292
215,LP6005441-DNA_A12,4,95687,183043,183043,0.52276,123382,59661,2.068051156
216,LP6005441-DNA_A12,5,81562,140029,140029,0.58247,94244,45785,2.058403407
217,LP6005441-DNA_A12,6,77544,154184,154184,0.50293,105195,48989,2.147318786
218,LP6005441-DNA_A12,7,68259,130438,130438,0.52331,88674,41764,2.123216167
219,LP6005441-DNA_A12,8,67693,127134,127134,0.53245,84060,43074,1.951525282
220,LP6005441-DNA_A12,9,55682,97244,97244,0.5726,65068,32176,2.022252611
221,LP6005441-DNA_A12,MT,33,36,36,0.91667,35,1,35
222,LP6005441-DNA_A12,X,41798,61004,61004,0.68517,41027,19977,2.053711769
223,LP6005441-DNA_B01,1,79177,197558,197558,0.40078,136119,61439,2.215514575
224,LP6005441-DNA_B01,10,50779,132369,132369,0.38362,91035,41334,2.202424154
225,LP6005441-DNA_B01,11,50979,128551,128551,0.39657,87084,41467,2.100079581
226,LP6005441-DNA_B01,12,46859,122572,122572,0.3823,84152,38420,2.190317543
227,LP6005441-DNA_B01,13,42688,101991,101991,0.41855,69699,32292,2.158398365
228,LP6005441-DNA_B01,14,32776,81270,81270,0.4033,55617,25653,2.16805052
229,LP6005441-DNA_B01,15,28806,76773,76773,0.37521,52246,24527,2.130142292
230,LP6005441-DNA_B01,16,28149,77100,77100,0.3651,50608,26492,1.910312547
231,LP6005441-DNA_B01,17,23689,60855,60855,0.38927,43087,17768,2.424977488
232,LP6005441-DNA_B01,18,30730,80148,80148,0.38342,55160,24988,2.207459581
233,LP6005441-DNA_B01,19,15889,45480,45480,0.34936,32063,13417,2.389729448
234,LP6005441-DNA_B01,2,86031,218362,218362,0.39398,148391,69971,2.120750025
235,LP6005441-DNA_B01,20,20379,53241,53241,0.38277,37220,16021,2.323200799
236,LP6005441-DNA_B01,21,13563,37625,37625,0.36048,25752,11873,2.168954771
237,LP6005441-DNA_B01,22,10861,31549,31549,0.34426,22346,9203,2.428121265
238,LP6005441-DNA_B01,3,71251,182928,182928,0.3895,123751,59177,2.091200973
239,LP6005441-DNA_B01,4,77068,194240,194240,0.39677,131300,62940,2.086113759
240,LP6005441-DNA_B01,5,58504,163722,163722,0.35734,110912,52810,2.100208294
241,LP6005441-DNA_B01,6,63232,167378,167378,0.37778,114664,52714,2.175209622
242,LP6005441-DNA_B01,7,53466,139367,139367,0.38363,94786,44581,2.126152397
243,LP6005441-DNA_B01,8,51964,142081,142081,0.36574,93882,48199,1.947799747
244,LP6005441-DNA_B01,9,40111,108319,108319,0.3703,72649,35670,2.036697505
245,LP6005441-DNA_B01,MT,12,15,15,0.8,14,1,14
246,LP6005441-DNA_B01,X,25331,64356,64356,0.39361,43523,20833,2.089137426
247,LP6005441-DNA_B02,1,75856,229298,229298,0.33082,158085,71213,2.219889627
248,LP6005441-DNA_B02,10,50779,149815,149815,0.33894,103058,46757,2.204119169
249,LP6005441-DNA_B02,11,48818,148547,148547,0.32864,101208,47339,2.137941232
250,LP6005441-DNA_B02,12,50915,148272,148272,0.34339,102102,46170,2.211435997
251,LP6005441-DNA_B02,13,38415,113248,113248,0.33921,77178,36070,2.139672858
252,LP6005441-DNA_B02,14,31404,96057,96057,0.32693,65896,30161,2.184808196
253,LP6005441-DNA_B02,15,31166,93046,93046,0.33495,63406,29640,2.139203779
254,LP6005441-DNA_B02,16,30665,92232,92232,0.33248,60617,31615,1.917349359
255,LP6005441-DNA_B02,17,25868,75095,75095,0.34447,53038,22057,2.404588113
256,LP6005441-DNA_B02,18,30584,88722,88722,0.34472,60756,27966,2.172495173
257,LP6005441-DNA_B02,19,17593,55911,55911,0.31466,39600,16311,2.427809454
258,LP6005441-DNA_B02,2,84678,258111,258111,0.32807,175599,82512,2.128163176
259,LP6005441-DNA_B02,20,23460,72875,72875,0.32192,51010,21865,2.332952207
260,LP6005441-DNA_B02,21,17094,45021,45021,0.37969,30779,14242,2.161143098
261,LP6005441-DNA_B02,22,12738,36392,36392,0.35002,25821,10571,2.442626052
262,LP6005441-DNA_B02,3,79308,217380,217380,0.36484,147115,70265,2.093716644
263,LP6005441-DNA_B02,4,76950,229296,229296,0.33559,154937,74359,2.083634799
264,LP6005441-DNA_B02,5,64999,200904,200904,0.32353,136007,64897,2.095736321
265,LP6005441-DNA_B02,6,65791,194330,194330,0.33855,133392,60938,2.188978962
266,LP6005441-DNA_B02,7,57760,172522,172522,0.3348,117228,55294,2.120085362
267,LP6005441-DNA_B02,8,58438,174156,174156,0.33555,115825,58331,1.985650855
268,LP6005441-DNA_B02,9,44440,136749,136749,0.32497,91701,45048,2.035628663
269,LP6005441-DNA_B02,MT,38,40,40,0.95,39,1,39
270,LP6005441-DNA_B02,X,37258,104992,104992,0.35487,70798,34194,2.070480201
271,LP6005441-DNA_B03,1,92317,191898,191898,0.48107,132149,59749,2.211735761
272,LP6005441-DNA_B03,10,60333,123103,123103,0.4901,84662,38441,2.202388075
273,LP6005441-DNA_B03,11,58373,121485,121485,0.4805,82351,39134,2.104333827
274,LP6005441-DNA_B03,12,1837,3369,3369,0.54527,2297,1072,2.142723881
275,LP6005441-DNA_B03,13,49488,97053,97053,0.50991,65933,31120,2.118669666
276,LP6005441-DNA_B03,14,36999,84010,84010,0.44041,57330,26680,2.1488006
277,LP6005441-DNA_B03,15,35489,71192,71192,0.4985,48437,22755,2.12863107
278,LP6005441-DNA_B03,16,34851,74499,74499,0.4678,48967,25532,1.917867774
279,LP6005441-DNA_B03,17,27996,58665,58665,0.47722,41228,17437,2.364397545
280,LP6005441-DNA_B03,18,36637,76030,76030,0.48188,51943,24087,2.156474447
281,LP6005441-DNA_B03,19,18208,41245,41245,0.44146,29075,12170,2.389071487
282,LP6005441-DNA_B03,2,102429,204187,204187,0.50164,138610,65577,2.1136984
283,LP6005441-DNA_B03,20,25182,54876,54876,0.45889,38197,16679,2.290125307
284,LP6005441-DNA_B03,21,18854,36087,36087,0.52246,24592,11495,2.139364941
285,LP6005441-DNA_B03,22,14493,27217,27217,0.5325,19249,7968,2.415788153
286,LP6005441-DNA_B03,3,86227,187534,187534,0.45979,126941,60593,2.094977968
287,LP6005441-DNA_B03,4,88806,189337,189337,0.46904,127797,61540,2.076649334
288,LP6005441-DNA_B03,5,68055,159222,159222,0.42742,107227,51995,2.062255986
289,LP6005441-DNA_B03,6,80438,160921,160921,0.49986,110065,50856,2.164248073
290,LP6005441-DNA_B03,7,56631,141694,141694,0.39967,96296,45398,2.121150711
291,LP6005441-DNA_B03,8,60707,140614,140614,0.43173,93198,47416,1.965539059
292,LP6005441-DNA_B03,9,47089,105582,105582,0.44599,70576,35006,2.016111524
293,LP6005441-DNA_B03,MT,47,50,50,0.94,48,2,24
294,LP6005441-DNA_B03,X,38940,71097,71097,0.5477,47853,23244,2.058724832
295,LP6005441-DNA_B04,1,93093,186474,186474,0.49923,128589,57885,2.221456336
296,LP6005441-DNA_B04,10,55831,119563,119563,0.46696,82108,37455,2.192177279
297,LP6005441-DNA_B04,11,61322,116341,116341,0.52709,78821,37520,2.100772921
298,LP6005441-DNA_B04,12,57338,111888,111888,0.51246,76884,35004,2.196434693
299,LP6005441-DNA_B04,13,48794,96189,96189,0.50727,65515,30674,2.135847949
300,LP6005441-DNA_B04,14,39771,78515,78515,0.50654,53411,25104,2.127589229
301,LP6005441-DNA_B04,15,33647,68317,68317,0.49251,46572,21745,2.141733732
302,LP6005441-DNA_B04,16,33359,68159,68159,0.48943,44716,23443,1.907435055
303,LP6005441-DNA_B04,17,23707,54768,54768,0.43286,38619,16149,2.391417425
304,LP6005441-DNA_B04,18,35620,72295,72295,0.4927,49579,22716,2.182558549
305,LP6005441-DNA_B04,19,16369,36881,36881,0.44383,25966,10915,2.378928081
306,LP6005441-DNA_B04,2,100407,205579,205579,0.48841,139212,66367,2.097608751
307,LP6005441-DNA_B04,20,22325,50024,50024,0.44629,34950,15074,2.318561762
308,LP6005441-DNA_B04,21,15468,32905,32905,0.47008,22518,10387,2.167902185
309,LP6005441-DNA_B04,22,12940,25172,25172,0.51406,17694,7478,2.366140679
310,LP6005441-DNA_B04,3,86185,176413,176413,0.48854,119186,57227,2.082688242
311,LP6005441-DNA_B04,4,89498,186748,186748,0.47924,126034,60714,2.075863886
312,LP6005441-DNA_B04,5,70314,146871,146871,0.47875,99107,47764,2.07493091
313,LP6005441-DNA_B04,6,75081,159006,159006,0.47219,108561,50445,2.152066607
314,LP6005441-DNA_B04,7,62305,129485,129485,0.48118,87925,41560,2.115615977
315,LP6005441-DNA_B04,8,61530,130298,130298,0.47223,86137,44161,1.950521954
316,LP6005441-DNA_B04,9,48648,99150,99150,0.49065,66492,32658,2.036009554
317,LP6005441-DNA_B04,MT,43,44,44,0.97727,40,4,10
318,LP6005441-DNA_B04,X,33605,65446,65446,0.51348,44173,21273,2.076481925
319,LP6005441-DNA_B05,1,76251,188846,188846,0.40377,130568,58278,2.240433783
320,LP6005441-DNA_B05,10,47515,124521,124521,0.38158,85628,38893,2.201630113
321,LP6005441-DNA_B05,11,51605,121812,121812,0.42364,82860,38952,2.127233518
322,LP6005441-DNA_B05,12,45469,115480,115480,0.39374,79367,36113,2.197740426
323,LP6005441-DNA_B05,13,42499,96027,96027,0.44257,65534,30493,2.149148985
324,LP6005441-DNA_B05,14,31138,79085,79085,0.39373,54073,25012,2.161882296
325,LP6005441-DNA_B05,15,29652,72558,72558,0.40867,49498,23060,2.146487424
326,LP6005441-DNA_B05,16,28379,71295,71295,0.39805,46681,24614,1.896522304
327,LP6005441-DNA_B05,17,22163,59544,59544,0.37221,42096,17448,2.412654746
328,LP6005441-DNA_B05,18,28755,72450,72450,0.39689,49692,22758,2.183495914
329,LP6005441-DNA_B05,19,15014,41114,41114,0.36518,28916,12198,2.37055255
330,LP6005441-DNA_B05,2,82993,206877,206877,0.40117,140428,66449,2.11331999
331,LP6005441-DNA_B05,20,19361,53195,53195,0.36396,37069,16126,2.298710158
332,LP6005441-DNA_B05,21,13709,34177,34177,0.40112,23513,10664,2.204894974
333,LP6005441-DNA_B05,22,9664,27617,27617,0.34993,19608,8009,2.448245724
334,LP6005441-DNA_B05,3,64608,172503,172503,0.37453,116737,55766,2.093336442
335,LP6005441-DNA_B05,4,75744,182532,182532,0.41496,123424,59108,2.088109901
336,LP6005441-DNA_B05,5,55994,154585,154585,0.36222,104443,50142,2.082944438
337,LP6005441-DNA_B05,6,58254,162000,162000,0.35959,110991,51009,2.175910134
338,LP6005441-DNA_B05,7,48729,134851,134851,0.36135,91855,42996,2.136361522
339,LP6005441-DNA_B05,8,52619,133633,133633,0.39376,88535,45098,1.963169098
340,LP6005441-DNA_B05,9,38861,102452,102452,0.37931,68461,33991,2.014091966
341,LP6005441-DNA_B05,MT,10,11,11,0.90909,NA,NA,NA
342,LP6005441-DNA_B05,X,25687,66953,66953,0.38366,45286,21667,2.090090922
343,LP6005441-DNA_B06,1,76179,196112,196112,0.38845,135595,60517,2.240610077
344,LP6005441-DNA_B06,10,51812,126706,126706,0.40892,87350,39356,2.219483687
345,LP6005441-DNA_B06,11,51209,129268,129268,0.39615,87622,41646,2.10397157
346,LP6005441-DNA_B06,12,47497,122923,122923,0.3864,84429,38494,2.193302852
347,LP6005441-DNA_B06,13,43851,101714,101714,0.43112,69480,32234,2.155487994
348,LP6005441-DNA_B06,14,31159,82382,82382,0.37823,56358,26024,2.165616354
349,LP6005441-DNA_B06,15,32148,71646,71646,0.44871,48604,23042,2.109365506
350,LP6005441-DNA_B06,16,27651,73447,73447,0.37648,48266,25181,1.916762638
351,LP6005441-DNA_B06,17,23521,58550,58550,0.40173,41443,17107,2.422575554
352,LP6005441-DNA_B06,18,30628,74147,74147,0.41307,50912,23235,2.191177104
353,LP6005441-DNA_B06,19,15707,42380,42380,0.37062,29727,12653,2.349403304
354,LP6005441-DNA_B06,2,86809,213574,213574,0.40646,145115,68459,2.1197359
355,LP6005441-DNA_B06,20,20536,54553,54553,0.37644,38173,16380,2.33046398
356,LP6005441-DNA_B06,21,12798,35874,35874,0.35675,24674,11200,2.203035714
357,LP6005441-DNA_B06,22,10033,28316,28316,0.35432,20125,8191,2.456964962
358,LP6005441-DNA_B06,3,69638,184484,184484,0.37747,124476,60008,2.074323424
359,LP6005441-DNA_B06,4,76530,188635,188635,0.4057,127629,61006,2.092072911
360,LP6005441-DNA_B06,5,59706,160972,160972,0.37091,108848,52124,2.088251094
361,LP6005441-DNA_B06,6,60921,164535,164535,0.37026,112600,51935,2.168094734
362,LP6005441-DNA_B06,7,51028,140147,140147,0.3641,95265,44882,2.122565839
363,LP6005441-DNA_B06,8,51275,141824,141824,0.36154,94130,47694,1.973623517
364,LP6005441-DNA_B06,9,41535,106190,106190,0.39114,70838,35352,2.00379045
365,LP6005441-DNA_B06,MT,16,19,19,0.84211,17,2,8.5
366,LP6005441-DNA_B06,X,19963,50732,50732,0.3935,34160,16572,2.061308231
367,LP6005441-DNA_B07,1,90567,199926,199926,0.453,137844,62082,2.220353726
368,LP6005441-DNA_B07,10,53357,132846,132846,0.40165,91512,41334,2.213964291
369,LP6005441-DNA_B07,11,60477,125590,125590,0.48154,85340,40250,2.120248447
370,LP6005441-DNA_B07,12,51448,123583,123583,0.4163,85056,38527,2.207698497
371,LP6005441-DNA_B07,13,45411,102969,102969,0.44102,70268,32701,2.148802789
372,LP6005441-DNA_B07,14,35441,80984,80984,0.43763,55377,25607,2.162572734
373,LP6005441-DNA_B07,15,32498,74769,74769,0.43465,50855,23914,2.126578573
374,LP6005441-DNA_B07,16,32331,74792,74792,0.43228,49048,25744,1.905220634
375,LP6005441-DNA_B07,17,25826,60043,60043,0.43013,42345,17698,2.392643237
376,LP6005441-DNA_B07,18,35726,77805,77805,0.45917,53316,24489,2.177140757
377,LP6005441-DNA_B07,19,15209,42591,42591,0.35709,29935,12656,2.36528129
378,LP6005441-DNA_B07,2,94340,215233,215233,0.43832,146299,68934,2.122305394
379,LP6005441-DNA_B07,20,22757,53208,53208,0.4277,37059,16149,2.294817017
380,LP6005441-DNA_B07,21,15701,35809,35809,0.43847,24428,11381,2.146384325
381,LP6005441-DNA_B07,22,11506,30652,30652,0.37538,21665,8987,2.410704351
382,LP6005441-DNA_B07,3,81155,188018,188018,0.43163,127180,60838,2.090469772
383,LP6005441-DNA_B07,4,85571,194651,194651,0.43961,131408,63243,2.077826795
384,LP6005441-DNA_B07,5,63672,154656,154656,0.4117,104437,50219,2.079631215
385,LP6005441-DNA_B07,6,71199,166281,166281,0.42818,113857,52424,2.171848772
386,LP6005441-DNA_B07,7,61521,144005,144005,0.42721,98191,45814,2.143253154
387,LP6005441-DNA_B07,8,56202,137162,137162,0.40975,90920,46242,1.966177933
388,LP6005441-DNA_B07,9,47295,108487,108487,0.43595,72638,35849,2.026221094
389,LP6005441-DNA_B07,MT,39,41,41,0.95122,38,3,12.66666667
390,LP6005441-DNA_B07,X,34076,70584,70584,0.48277,47650,22934,2.07770123
391,LP6005441-DNA_B08,1,87081,241238,241238,0.36098,166282,74956,2.218394792
392,LP6005441-DNA_B08,10,56442,153898,153898,0.36675,105769,48129,2.197614744
393,LP6005441-DNA_B08,11,59312,147197,147197,0.40294,100052,47145,2.122218687
394,LP6005441-DNA_B08,12,57511,143323,143323,0.40127,98557,44766,2.201603896
395,LP6005441-DNA_B08,13,44763,119328,119328,0.37513,81478,37850,2.152655218
396,LP6005441-DNA_B08,14,34232,103403,103403,0.33105,70565,32838,2.148882392
397,LP6005441-DNA_B08,15,33505,90143,90143,0.37169,61458,28685,2.142513509
398,LP6005441-DNA_B08,16,32494,93823,93823,0.34633,61586,32237,1.9104135
399,LP6005441-DNA_B08,17,27748,77356,77356,0.35871,54635,22721,2.404603671
400,LP6005441-DNA_B08,18,32142,94180,94180,0.34128,64725,29455,2.197419793
401,LP6005441-DNA_B08,19,20585,57576,57576,0.35753,40649,16927,2.401429669
402,LP6005441-DNA_B08,2,99606,270959,270959,0.36761,183757,87202,2.107256714
403,LP6005441-DNA_B08,20,26165,69175,69175,0.37824,48412,20763,2.331647642
404,LP6005441-DNA_B08,21,17368,46737,46737,0.37161,31786,14951,2.126011638
405,LP6005441-DNA_B08,22,13022,35908,35908,0.36265,25298,10610,2.384354383
406,LP6005441-DNA_B08,3,84413,228837,228837,0.36888,154676,74161,2.085678456
407,LP6005441-DNA_B08,4,88421,236362,236362,0.37409,159497,76865,2.075027646
408,LP6005441-DNA_B08,5,75568,203798,203798,0.3708,137771,66027,2.086585791
409,LP6005441-DNA_B08,6,76048,205774,205774,0.36957,141029,64745,2.178222257
410,LP6005441-DNA_B08,7,70007,174116,174116,0.40207,118089,56027,2.107715923
411,LP6005441-DNA_B08,8,69092,180465,180465,0.38286,119690,60775,1.969395311
412,LP6005441-DNA_B08,9,50104,137136,137136,0.36536,91932,45204,2.033713831
413,LP6005441-DNA_B08,MT,85,91,91,0.93407,88,3,29.33333333
414,LP6005441-DNA_B08,X,44745,112000,112000,0.39951,75268,36732,2.04911249
415,LP6005441-DNA_B09,1,83452,193868,193868,0.43046,133477,60391,2.210213442
416,LP6005441-DNA_B09,10,52425,123955,123955,0.42294,85254,38701,2.202888814
417,LP6005441-DNA_B09,11,54712,129661,129661,0.42196,87985,41676,2.111167099
418,LP6005441-DNA_B09,12,51877,115782,115782,0.44806,79178,36604,2.163096929
419,LP6005441-DNA_B09,13,47828,101294,101294,0.47217,68786,32508,2.115971453
420,LP6005441-DNA_B09,14,33504,83460,83460,0.40144,56913,26547,2.143858063
421,LP6005441-DNA_B09,15,31657,69086,69086,0.45823,46873,22213,2.110160717
422,LP6005441-DNA_B09,16,29057,67314,67314,0.43166,44169,23145,1.908360337
423,LP6005441-DNA_B09,17,24187,53579,53579,0.45143,37664,15915,2.366572416
424,LP6005441-DNA_B09,18,32740,76246,76246,0.4294,52316,23930,2.186209779
425,LP6005441-DNA_B09,19,12459,34541,34541,0.3607,24223,10318,2.347644892
426,LP6005441-DNA_B09,2,92511,210228,210228,0.44005,142493,67735,2.103683472
427,LP6005441-DNA_B09,20,21531,50929,50929,0.42277,35377,15552,2.274755658
428,LP6005441-DNA_B09,21,15424,35223,35223,0.4379,24034,11189,2.148002502
429,LP6005441-DNA_B09,22,10016,24548,24548,0.40802,17321,7227,2.396706794
430,LP6005441-DNA_B09,3,79905,182245,182245,0.43845,122852,59393,2.068459246
431,LP6005441-DNA_B09,4,80618,195343,195343,0.4127,131785,63558,2.073460461
432,LP6005441-DNA_B09,5,62671,153001,153001,0.40961,103209,49792,2.07280286
433,LP6005441-DNA_B09,6,70605,162692,162692,0.43398,111307,51385,2.166137978
434,LP6005441-DNA_B09,7,57122,134829,134829,0.42366,91573,43256,2.11700111
435,LP6005441-DNA_B09,8,56267,138364,138364,0.40666,91490,46874,1.951828306
436,LP6005441-DNA_B09,9,44351,104916,104916,0.42273,70052,34864,2.009293254
437,LP6005441-DNA_B09,MT,33,36,36,0.91667,35,1,35
438,LP6005441-DNA_B09,X,31201,68405,68405,0.45612,46085,22320,2.064740143
439,LP6005441-DNA_B10,1,92325,182609,182609,0.50559,125749,56860,2.211554696
440,LP6005441-DNA_B10,10,58721,118122,118122,0.49712,81213,36909,2.200357636
441,LP6005441-DNA_B10,11,58641,116493,116493,0.50339,78813,37680,2.091640127
442,LP6005441-DNA_B10,12,56331,116362,116362,0.4841,79780,36582,2.180853972
443,LP6005441-DNA_B10,13,49199,93220,93220,0.52777,63383,29837,2.124308744
444,LP6005441-DNA_B10,14,39345,80331,80331,0.48979,54791,25540,2.145301488
445,LP6005441-DNA_B10,15,35571,67747,67747,0.52506,46092,21655,2.128469176
446,LP6005441-DNA_B10,16,32458,67231,67231,0.48278,44078,23153,1.90377057
447,LP6005441-DNA_B10,17,27919,55739,55739,0.50089,39260,16479,2.382426118
448,LP6005441-DNA_B10,18,36570,71338,71338,0.51263,48801,22537,2.165372499
449,LP6005441-DNA_B10,19,20023,38986,38986,0.51359,27267,11719,2.326734363
450,LP6005441-DNA_B10,2,104105,196306,196306,0.53032,133013,63293,2.101543615
451,LP6005441-DNA_B10,20,24580,50995,50995,0.48201,35512,15483,2.293612349
452,LP6005441-DNA_B10,21,16568,34436,34436,0.48112,23500,10936,2.14886613
453,LP6005441-DNA_B10,22,12922,26526,26526,0.48714,18805,7721,2.435565341
454,LP6005441-DNA_B10,3,86656,180239,180239,0.48078,121849,58390,2.08681281
455,LP6005441-DNA_B10,4,90641,179284,179284,0.50557,121060,58224,2.079211322
456,LP6005441-DNA_B10,5,72872,148862,148862,0.48953,100322,48540,2.066790276
457,LP6005441-DNA_B10,6,75239,155889,155889,0.48264,106576,49313,2.161215095
458,LP6005441-DNA_B10,7,58525,127319,127319,0.45967,86556,40763,2.123396217
459,LP6005441-DNA_B10,8,64204,127962,127962,0.50174,84857,43105,1.96861153
460,LP6005441-DNA_B10,9,47758,98916,98916,0.48281,66176,32740,2.0212584
461,LP6005441-DNA_B10,MT,23,24,24,0.95833,NA,NA,NA
462,LP6005441-DNA_B10,X,36025,64125,64125,0.56179,43238,20887,2.070091444
463,LP6005441-DNA_B11,1,92315,249419,249419,0.37012,172187,77232,2.229477419
464,LP6005441-DNA_B11,10,60265,160298,160298,0.37596,110003,50295,2.187155781
465,LP6005441-DNA_B11,11,61532,159614,159614,0.38551,108760,50854,2.138671491
466,LP6005441-DNA_B11,12,67634,137319,137319,0.49253,94410,42909,2.200237712
467,LP6005441-DNA_B11,13,46647,119257,119257,0.39115,81076,38181,2.12346455
468,LP6005441-DNA_B11,14,39029,105230,105230,0.37089,72000,33230,2.166716822
469,LP6005441-DNA_B11,15,33573,94112,94112,0.35673,64116,29996,2.137484998
470,LP6005441-DNA_B11,16,34666,97709,97709,0.35479,64187,33522,1.914772388
471,LP6005441-DNA_B11,17,28399,79714,79714,0.35626,56287,23427,2.402655056
472,LP6005441-DNA_B11,18,34665,96858,96858,0.3579,66348,30510,2.174631268
473,LP6005441-DNA_B11,19,23232,59815,59815,0.3884,42181,17634,2.392026766
474,LP6005441-DNA_B11,2,100957,279814,279814,0.3608,189798,90016,2.108491824
475,LP6005441-DNA_B11,20,27554,74702,74702,0.36885,52109,22593,2.306422343
476,LP6005441-DNA_B11,21,19448,47742,47742,0.40736,32578,15164,2.148377737
477,LP6005441-DNA_B11,22,13408,39077,39077,0.34312,27656,11421,2.421504247
478,LP6005441-DNA_B11,3,86056,238761,238761,0.36043,161470,77291,2.08911775
479,LP6005441-DNA_B11,4,91606,242354,242354,0.37798,163911,78443,2.089555473
480,LP6005441-DNA_B11,5,79589,208208,208208,0.38226,140879,67329,2.092397035
481,LP6005441-DNA_B11,6,77886,210728,210728,0.3696,144279,66449,2.17127421
482,LP6005441-DNA_B11,7,72860,181348,181348,0.40177,122893,58455,2.102352237
483,LP6005441-DNA_B11,8,69725,187090,187090,0.37268,124146,62944,1.972324606
484,LP6005441-DNA_B11,9,50448,141960,141960,0.35537,95122,46838,2.030872369
485,LP6005441-DNA_B11,MT,87,89,89,0.97753,84,5,16.8
486,LP6005441-DNA_B11,X,82001,84785,84785,0.96716,56001,28784,1.945560033
487,LP6005441-DNA_B11,Y,1745,1929,1929,0.90461,1164,765,1.521568627
488,LP6005441-DNA_B12,1,103653,183634,183634,0.56445,126779,56855,2.229865447
489,LP6005441-DNA_B12,10,74093,108474,108474,0.68305,74360,34114,2.179750249
490,LP6005441-DNA_B12,11,67151,115931,115931,0.57923,78786,37145,2.121039171
491,LP6005441-DNA_B12,12,60253,111486,111486,0.54045,76729,34757,2.207584084
492,LP6005441-DNA_B12,13,54550,94042,94042,0.58006,63990,30052,2.129309197
493,LP6005441-DNA_B12,14,42424,75684,75684,0.56054,51671,24013,2.151792779
494,LP6005441-DNA_B12,15,37218,70449,70449,0.5283,48057,22392,2.146168274
495,LP6005441-DNA_B12,16,39396,67328,67328,0.58514,44066,23262,1.894334107
496,LP6005441-DNA_B12,17,27492,60805,60805,0.45213,42771,18034,2.371686814
497,LP6005441-DNA_B12,18,38913,71157,71157,0.54686,48762,22395,2.177361018
498,LP6005441-DNA_B12,19,19715,41949,41949,0.46998,29472,12477,2.362106276
499,LP6005441-DNA_B12,2,113858,198277,198277,0.57424,134389,63888,2.103509266
500,LP6005441-DNA_B12,20,23192,52001,52001,0.44599,36364,15637,2.325510008
501,LP6005441-DNA_B12,21,17282,34927,34927,0.4948,23896,11031,2.166258725
502,LP6005441-DNA_B12,22,14291,27710,27710,0.51573,19515,8195,2.381330079
503,LP6005441-DNA_B12,3,96581,170284,170284,0.56718,115048,55236,2.082844522
504,LP6005441-DNA_B12,4,105846,173905,173905,0.60864,117424,56481,2.079000018
505,LP6005441-DNA_B12,5,74603,145735,145735,0.51191,98103,47632,2.059602788
506,LP6005441-DNA_B12,6,81791,152986,152986,0.53463,104751,48235,2.171680315
507,LP6005441-DNA_B12,7,63945,134503,134503,0.47542,91725,42778,2.14420964
508,LP6005441-DNA_B12,8,68166,124463,124463,0.54768,82298,42165,1.951808372
509,LP6005441-DNA_B12,9,50444,103963,103963,0.48521,69672,34291,2.031786766
510,LP6005441-DNA_B12,MT,37,39,39,0.94872,35,4,8.75
511,LP6005441-DNA_B12,X,42474,59709,59709,0.71135,40233,19476,2.065773259
512,LP6005441-DNA_C01,1,76121,200699,200699,0.37928,138468,62231,2.225064678
513,LP6005441-DNA_C01,10,49049,131759,131759,0.37226,90875,40884,2.222752177
514,LP6005441-DNA_C01,11,51281,128832,128832,0.39805,87688,41144,2.131246354
515,LP6005441-DNA_C01,12,46708,120140,120140,0.38878,82414,37726,2.184541165
516,LP6005441-DNA_C01,13,43925,101032,101032,0.43476,68797,32235,2.134232977
517,LP6005441-DNA_C01,14,34388,83286,83286,0.41289,56945,26341,2.161838958
518,LP6005441-DNA_C01,15,28365,74872,74872,0.37885,50956,23916,2.13062385
519,LP6005441-DNA_C01,16,30806,74930,74930,0.41113,49169,25761,1.908660378
520,LP6005441-DNA_C01,17,23990,64604,64604,0.37134,45677,18927,2.41332488
521,LP6005441-DNA_C01,18,30795,76310,76310,0.40355,52470,23840,2.200922819
522,LP6005441-DNA_C01,19,15887,45318,45318,0.35057,31833,13485,2.360622914
523,LP6005441-DNA_C01,2,85388,220846,220846,0.38664,149840,71006,2.110244205
524,LP6005441-DNA_C01,20,18859,54959,54959,0.34315,38422,16537,2.323396021
525,LP6005441-DNA_C01,21,13409,35036,35036,0.38272,24018,11018,2.179887457
526,LP6005441-DNA_C01,22,10684,30126,30126,0.35464,21365,8761,2.438648556
527,LP6005441-DNA_C01,3,82447,171385,171385,0.48106,115640,55745,2.074446139
528,LP6005441-DNA_C01,4,83661,189051,189051,0.44253,127915,61136,2.092302408
529,LP6005441-DNA_C01,5,59173,160647,160647,0.36834,108544,52103,2.083258162
530,LP6005441-DNA_C01,6,68649,164579,164579,0.41712,112752,51827,2.175545565
531,LP6005441-DNA_C01,7,50772,140989,140989,0.36011,96161,44828,2.145110199
532,LP6005441-DNA_C01,8,54010,143476,143476,0.37644,95243,48233,1.974643916
533,LP6005441-DNA_C01,9,40460,109470,109470,0.3696,73470,36000,2.040833333
534,LP6005441-DNA_C01,MT,30,32,32,0.9375,31,1,31
535,LP6005441-DNA_C01,X,51128,51999,51999,0.98325,34968,17031,2.053197111
536,LP6005441-DNA_C01,Y,658,674,674,0.97626,431,243,1.773662551
537,LP6005441-DNA_C02,1,80078,198610,198610,0.40319,137182,61428,2.233216123
538,LP6005441-DNA_C02,10,51698,127430,127430,0.4057,87857,39573,2.220124833
539,LP6005441-DNA_C02,11,52427,129810,129810,0.40387,88287,41523,2.126219204
540,LP6005441-DNA_C02,12,47543,122003,122003,0.38969,83923,38080,2.203860294
541,LP6005441-DNA_C02,13,43129,101134,101134,0.42645,69052,32082,2.152359579
542,LP6005441-DNA_C02,14,31896,84583,84583,0.3771,58017,26566,2.183881653
543,LP6005441-DNA_C02,15,31643,74448,74448,0.42503,50740,23708,2.140205838
544,LP6005441-DNA_C02,16,29997,77511,77511,0.387,50880,26631,1.910555368
545,LP6005441-DNA_C02,17,25614,64870,64870,0.39485,45972,18898,2.432638374
546,LP6005441-DNA_C02,18,29833,76450,76450,0.39023,52577,23873,2.202362502
547,LP6005441-DNA_C02,19,17022,47535,47535,0.35809,33421,14114,2.367932549
548,LP6005441-DNA_C02,2,85858,216057,216057,0.39739,147178,68879,2.136761567
549,LP6005441-DNA_C02,20,18667,55888,55888,0.33401,39043,16845,2.317779757
550,LP6005441-DNA_C02,21,14427,36114,36114,0.39948,24791,11323,2.189437428
551,LP6005441-DNA_C02,22,10143,30326,30326,0.33447,21551,8775,2.455954416
552,LP6005441-DNA_C02,3,72776,184764,184764,0.39389,125047,59717,2.093993335
553,LP6005441-DNA_C02,4,77771,190970,190970,0.40724,129132,61838,2.088230538
554,LP6005441-DNA_C02,5,59839,162162,162162,0.36901,109598,52564,2.08503919
555,LP6005441-DNA_C02,6,64300,165873,165873,0.38765,113633,52240,2.175210567
556,LP6005441-DNA_C02,7,54002,137418,137418,0.39298,93582,43836,2.134820695
557,LP6005441-DNA_C02,8,56039,140406,140406,0.39912,93147,47259,1.970989653
558,LP6005441-DNA_C02,9,41322,106773,106773,0.38701,71555,35218,2.031773525
559,LP6005441-DNA_C02,MT,13,14,14,0.92857,NA,NA,NA
560,LP6005441-DNA_C02,X,48589,49400,49400,0.98358,33392,16008,2.085957021
561,LP6005441-DNA_C02,Y,146,169,169,0.86391,91,78,1.166666667
562,LP6005441-DNA_C03,1,87987,191327,191327,0.45988,131899,59428,2.219475668
563,LP6005441-DNA_C03,10,51365,129482,129482,0.3967,89282,40200,2.220945274
564,LP6005441-DNA_C03,11,53106,128545,128545,0.41313,87146,41399,2.105026691
565,LP6005441-DNA_C03,12,47114,121243,121243,0.38859,83368,37875,2.201135314
566,LP6005441-DNA_C03,13,46829,97639,97639,0.47961,66536,31103,2.139214867
567,LP6005441-DNA_C03,14,37757,79271,79271,0.4763,54140,25131,2.154311408
568,LP6005441-DNA_C03,15,28258,74888,74888,0.37734,50990,23898,2.133651352
569,LP6005441-DNA_C03,16,28661,75424,75424,0.38,49664,25760,1.927950311
570,LP6005441-DNA_C03,17,22984,62741,62741,0.36633,44418,18323,2.424166348
571,LP6005441-DNA_C03,18,33344,70596,70596,0.47232,48702,21894,2.224445053
572,LP6005441-DNA_C03,19,16639,42428,42428,0.39217,29941,12487,2.397773685
573,LP6005441-DNA_C03,2,96496,201832,201832,0.4781,137026,64806,2.114402987
574,LP6005441-DNA_C03,20,20194,53327,53327,0.37868,37268,16059,2.320692447
575,LP6005441-DNA_C03,21,14343,36332,36332,0.39478,24970,11362,2.197676465
576,LP6005441-DNA_C03,22,12073,30370,30370,0.39753,21498,8872,2.423128945
577,LP6005441-DNA_C03,3,68964,183434,183434,0.37596,124194,59240,2.096455098
578,LP6005441-DNA_C03,4,73172,194248,194248,0.37669,131296,62952,2.085652561
579,LP6005441-DNA_C03,5,65483,157064,157064,0.41692,106071,50993,2.080109035
580,LP6005441-DNA_C03,6,69706,159751,159751,0.43634,109417,50334,2.17381889
581,LP6005441-DNA_C03,7,50601,141148,141148,0.3585,96122,45026,2.134810998
582,LP6005441-DNA_C03,8,54399,137485,137485,0.39567,91163,46322,1.968028151
583,LP6005441-DNA_C03,9,46037,100028,100028,0.46024,66709,33319,2.002130916
584,LP6005441-DNA_C03,MT,34,38,38,0.89474,35,3,11.66666667
585,LP6005441-DNA_C03,X,52085,52955,52955,0.98357,35655,17300,2.060982659
586,LP6005441-DNA_C03,Y,650,704,704,0.9233,465,239,1.945606695
587,LP6005441-DNA_C05,1,88260,190142,190142,0.46418,131003,59139,2.215171038
588,LP6005441-DNA_C05,10,54059,123827,123827,0.43657,85165,38662,2.20280896
589,LP6005441-DNA_C05,11,54699,119168,119168,0.45901,80970,38198,2.119744489
590,LP6005441-DNA_C05,12,50224,119361,119361,0.42077,82011,37350,2.195742972
591,LP6005441-DNA_C05,13,44247,96598,96598,0.45805,65896,30702,2.146309687
592,LP6005441-DNA_C05,14,33403,79940,79940,0.41785,54615,25325,2.156564659
593,LP6005441-DNA_C05,15,32634,72139,72139,0.45238,49144,22995,2.137160252
594,LP6005441-DNA_C05,16,30091,72205,72205,0.41674,47254,24951,1.893871989
595,LP6005441-DNA_C05,17,24817,58271,58271,0.42589,41165,17106,2.406465568
596,LP6005441-DNA_C05,18,32274,73615,73615,0.43842,50398,23217,2.17073696
597,LP6005441-DNA_C05,19,15000,40433,40433,0.37098,28367,12066,2.350986242
598,LP6005441-DNA_C05,2,90230,207029,207029,0.43583,140252,66777,2.100303997
599,LP6005441-DNA_C05,20,21521,54080,54080,0.39795,37772,16308,2.316163846
600,LP6005441-DNA_C05,21,14651,33664,33664,0.43521,22950,10714,2.142057122
601,LP6005441-DNA_C05,22,11950,29139,29139,0.4101,20628,8511,2.423686993
602,LP6005441-DNA_C05,3,76426,181325,181325,0.42149,122370,58955,2.07565092
603,LP6005441-DNA_C05,4,80430,181122,181122,0.44407,122282,58840,2.078212101
604,LP6005441-DNA_C05,5,57107,148216,148216,0.3853,100019,48197,2.07521215
605,LP6005441-DNA_C05,6,66908,162104,162104,0.41275,111110,50994,2.17888379
606,LP6005441-DNA_C05,7,56479,137493,137493,0.41078,93506,43987,2.12576443
607,LP6005441-DNA_C05,8,54031,134360,134360,0.40214,88926,45434,1.95725668
608,LP6005441-DNA_C05,9,43994,101715,101715,0.43252,68038,33677,2.020310598
609,LP6005441-DNA_C05,MT,43,45,45,0.95556,44,1,44
610,LP6005441-DNA_C05,X,51136,51860,51860,0.98604,34880,16980,2.05418139
611,LP6005441-DNA_C05,Y,627,643,643,0.97512,416,227,1.832599119
612,LP6005441-DNA_C06,1,87001,195379,195379,0.44529,134538,60841,2.211304877
613,LP6005441-DNA_C06,10,55692,126883,126883,0.43892,87318,39565,2.206950588
614,LP6005441-DNA_C06,11,57118,123888,123888,0.46105,84119,39769,2.115190224
615,LP6005441-DNA_C06,12,56141,123146,123146,0.45589,84504,38642,2.186843331
616,LP6005441-DNA_C06,13,46613,101757,101757,0.45808,69319,32438,2.136968987
617,LP6005441-DNA_C06,14,33577,83416,83416,0.40252,56930,26486,2.149437439
618,LP6005441-DNA_C06,15,32055,75110,75110,0.42677,51282,23828,2.152173913
619,LP6005441-DNA_C06,16,30215,73411,73411,0.41159,48119,25292,1.902538352
620,LP6005441-DNA_C06,17,24240,58011,58011,0.41785,40925,17086,2.395235866
621,LP6005441-DNA_C06,18,35172,75577,75577,0.46538,51827,23750,2.182189474
622,LP6005441-DNA_C06,19,14134,41900,41900,0.33733,29365,12535,2.342640606
623,LP6005441-DNA_C06,2,95725,214246,214246,0.4468,145306,68940,2.107716855
624,LP6005441-DNA_C06,20,22784,53207,53207,0.42821,37192,16015,2.322322822
625,LP6005441-DNA_C06,21,15391,34267,34267,0.44915,23469,10798,2.173458048
626,LP6005441-DNA_C06,22,11150,29829,29829,0.3738,21150,8679,2.436916695
627,LP6005441-DNA_C06,3,80240,186285,186285,0.43074,125992,60293,2.08966215
628,LP6005441-DNA_C06,4,88491,188673,188673,0.46902,127465,61208,2.082489217
629,LP6005441-DNA_C06,5,60978,154976,154976,0.39347,104428,50548,2.065917544
630,LP6005441-DNA_C06,6,66282,167142,167142,0.39656,114390,52752,2.16844859
631,LP6005441-DNA_C06,7,59126,139265,139265,0.42456,94747,44518,2.128285188
632,LP6005441-DNA_C06,8,53317,136213,136213,0.39142,90119,46094,1.955113464
633,LP6005441-DNA_C06,9,45028,106060,106060,0.42455,70680,35380,1.997738836
634,LP6005441-DNA_C06,MT,30,32,32,0.9375,29,3,9.666666667
635,LP6005441-DNA_C06,X,48832,49382,49382,0.98886,33285,16097,2.067776604
636,LP6005441-DNA_C06,Y,632,645,645,0.97984,426,219,1.945205479
637,LP6005441-DNA_C07,1,77265,206310,206310,0.37451,142506,63804,2.233496333
638,LP6005441-DNA_C07,10,50022,133651,133651,0.37427,92143,41508,2.219885323
639,LP6005441-DNA_C07,11,54047,132909,132909,0.40665,90409,42500,2.127270588
640,LP6005441-DNA_C07,12,47497,128183,128183,0.37054,88144,40039,2.201453583
641,LP6005441-DNA_C07,13,42877,102878,102878,0.41678,70236,32642,2.151706391
642,LP6005441-DNA_C07,14,33544,87178,87178,0.38478,59571,27607,2.157822291
643,LP6005441-DNA_C07,15,29424,77884,77884,0.37779,53023,24861,2.132778247
644,LP6005441-DNA_C07,16,30498,80549,80549,0.37863,52839,27710,1.90685673
645,LP6005441-DNA_C07,17,24820,67215,67215,0.36926,47620,19595,2.430211789
646,LP6005441-DNA_C07,18,30520,76564,76564,0.39862,52558,24006,2.189369324
647,LP6005441-DNA_C07,19,16996,48241,48241,0.35231,34049,14192,2.399168546
648,LP6005441-DNA_C07,2,83665,222081,222081,0.37673,151113,70968,2.129311803
649,LP6005441-DNA_C07,20,20466,58948,58948,0.34719,41208,17740,2.322886133
650,LP6005441-DNA_C07,21,14435,36811,36811,0.39214,25142,11669,2.154597652
651,LP6005441-DNA_C07,22,10510,32338,32338,0.325,22941,9397,2.441311057
652,LP6005441-DNA_C07,3,69682,186371,186371,0.37389,126207,60164,2.097716242
653,LP6005441-DNA_C07,4,80723,190376,190376,0.42402,129248,61128,2.114382934
654,LP6005441-DNA_C07,5,59481,167637,167637,0.35482,113727,53910,2.109571508
655,LP6005441-DNA_C07,6,64768,167526,167526,0.38661,115309,52217,2.208265507
656,LP6005441-DNA_C07,7,53702,144291,144291,0.37218,98404,45887,2.144485366
657,LP6005441-DNA_C07,8,53692,139847,139847,0.38393,92724,47123,1.967701547
658,LP6005441-DNA_C07,9,42201,111003,111003,0.38018,74347,36656,2.028235487
659,LP6005441-DNA_C07,MT,54,56,56,0.96429,54,2,27
660,LP6005441-DNA_C07,X,49370,49901,49901,0.98936,33542,16359,2.050369827
661,LP6005441-DNA_C07,Y,663,701,701,0.94579,440,261,1.685823755
662,LP6005441-DNA_C08,1,86405,196752,196752,0.43916,135341,61411,2.203855987
663,LP6005441-DNA_C08,10,53538,128414,128414,0.41692,88283,40131,2.199870424
664,LP6005441-DNA_C08,11,53828,125298,125298,0.4296,84774,40524,2.091945514
665,LP6005441-DNA_C08,12,55760,113700,113700,0.49041,77810,35890,2.168013374
666,LP6005441-DNA_C08,13,49030,101225,101225,0.48437,68789,32436,2.120760883
667,LP6005441-DNA_C08,14,34166,83489,83489,0.40923,56903,26586,2.140337019
668,LP6005441-DNA_C08,15,31178,72001,72001,0.43302,49082,22919,2.141541952
669,LP6005441-DNA_C08,16,29066,71819,71819,0.40471,46988,24831,1.892312029
670,LP6005441-DNA_C08,17,24548,57040,57040,0.43036,40128,16912,2.372753075
671,LP6005441-DNA_C08,18,35713,76180,76180,0.4688,52119,24061,2.166119446
672,LP6005441-DNA_C08,19,13648,40238,40238,0.33918,28201,12037,2.342859516
673,LP6005441-DNA_C08,2,95948,208732,208732,0.45967,141306,67426,2.095719752
674,LP6005441-DNA_C08,20,21521,52192,52192,0.41234,36259,15933,2.275717065
675,LP6005441-DNA_C08,21,14076,34954,34954,0.4027,23842,11112,2.145608351
676,LP6005441-DNA_C08,22,11286,28252,28252,0.39948,19901,8351,2.383067896
677,LP6005441-DNA_C08,3,80681,185660,185660,0.43456,125288,60372,2.07526668
678,LP6005441-DNA_C08,4,86084,190993,190993,0.45072,129004,61989,2.081078901
679,LP6005441-DNA_C08,5,62922,157186,157186,0.4003,105841,51345,2.061369169
680,LP6005441-DNA_C08,6,73347,164905,164905,0.44478,112393,52512,2.140329829
681,LP6005441-DNA_C08,7,57652,137576,137576,0.41906,93331,44245,2.109413493
682,LP6005441-DNA_C08,8,55332,136042,136042,0.40673,89879,46163,1.94699218
683,LP6005441-DNA_C08,9,46406,105403,105403,0.44027,70389,35014,2.010310162
684,LP6005441-DNA_C08,MT,33,35,35,0.94286,33,2,16.5
685,LP6005441-DNA_C08,X,50791,52516,52516,0.96715,34728,17788,1.952327412
686,LP6005441-DNA_C08,Y,664,767,767,0.86571,444,323,1.374613003
687,LP6005441-DNA_C09,1,78642,191444,191444,0.41078,131706,59738,2.204727309
688,LP6005441-DNA_C09,10,49689,129515,129515,0.38365,89176,40339,2.210664617
689,LP6005441-DNA_C09,11,50027,125782,125782,0.39773,85319,40463,2.108568322
690,LP6005441-DNA_C09,12,46644,114620,114620,0.40694,78726,35894,2.193291358
691,LP6005441-DNA_C09,13,42531,98312,98312,0.43261,66961,31351,2.135848936
692,LP6005441-DNA_C09,14,33960,80489,80489,0.42192,55105,25384,2.170855657
693,LP6005441-DNA_C09,15,29218,71213,71213,0.41029,48266,22947,2.103368632
694,LP6005441-DNA_C09,16,28283,72898,72898,0.38798,47880,25018,1.913822048
695,LP6005441-DNA_C09,17,21587,59948,59948,0.3601,42354,17594,2.407297942
696,LP6005441-DNA_C09,18,30575,75549,75549,0.4047,51784,23765,2.179002735
697,LP6005441-DNA_C09,19,14704,41273,41273,0.35626,29096,12177,2.389422682
698,LP6005441-DNA_C09,2,82107,215010,215010,0.38188,145810,69200,2.107080925
699,LP6005441-DNA_C09,20,18484,51547,51547,0.35859,36145,15402,2.346773146
700,LP6005441-DNA_C09,21,13669,35447,35447,0.38562,24223,11224,2.158143264
701,LP6005441-DNA_C09,22,9497,26908,26908,0.35294,19113,7795,2.451956382
702,LP6005441-DNA_C09,3,69015,182192,182192,0.3788,123158,59034,2.086221499
703,LP6005441-DNA_C09,4,77598,188783,188783,0.41104,127396,61387,2.075292814
704,LP6005441-DNA_C09,5,57456,153793,153793,0.37359,103851,49942,2.079432141
705,LP6005441-DNA_C09,6,60811,161265,161265,0.37709,110575,50690,2.181396725
706,LP6005441-DNA_C09,7,51866,139162,139162,0.3727,94622,44540,2.124427481
707,LP6005441-DNA_C09,8,53263,139472,139472,0.38189,92423,47049,1.964398818
708,LP6005441-DNA_C09,9,42112,102793,102793,0.40968,68614,34179,2.007489979
709,LP6005441-DNA_C09,MT,8,9,9,0.88889,NA,NA,NA
710,LP6005441-DNA_C09,X,50587,51431,51431,0.98359,34521,16910,2.04145476
711,LP6005441-DNA_C09,Y,121,137,137,0.88321,76,61,1.245901639
712,LP6005441-DNA_C10,1,75692,195087,195087,0.38799,134617,60470,2.22617827
713,LP6005441-DNA_C10,10,47418,124576,124576,0.38064,85855,38721,2.217272281
714,LP6005441-DNA_C10,11,50807,125485,125485,0.40489,85197,40288,2.114699166
715,LP6005441-DNA_C10,12,42582,116307,116307,0.36612,79898,36409,2.194457414
716,LP6005441-DNA_C10,13,43306,100592,100592,0.43051,68508,32084,2.135269916
717,LP6005441-DNA_C10,14,31695,81997,81997,0.38654,56110,25887,2.167497199
718,LP6005441-DNA_C10,15,27883,72670,72670,0.38369,49525,23145,2.139771009
719,LP6005441-DNA_C10,16,27887,71876,71876,0.38799,47114,24762,1.902673451
720,LP6005441-DNA_C10,17,21818,60005,60005,0.3636,42526,17479,2.432976715
721,LP6005441-DNA_C10,18,29573,75504,75504,0.39167,51877,23627,2.195665975
722,LP6005441-DNA_C10,19,14872,41281,41281,0.36026,29096,12185,2.387853919
723,LP6005441-DNA_C10,2,81148,216079,216079,0.37555,146877,69202,2.122438658
724,LP6005441-DNA_C10,20,18553,52781,52781,0.35151,36806,15975,2.303974961
725,LP6005441-DNA_C10,21,13077,35268,35268,0.37079,24069,11199,2.149209751
726,LP6005441-DNA_C10,22,9315,27847,27847,0.33451,19659,8188,2.400952614
727,LP6005441-DNA_C10,3,70266,181451,181451,0.38725,122565,58886,2.081394559
728,LP6005441-DNA_C10,4,76231,194351,194351,0.39223,131346,63005,2.084691691
729,LP6005441-DNA_C10,5,58157,160431,160431,0.3625,108550,51881,2.092288121
730,LP6005441-DNA_C10,6,60526,164012,164012,0.36903,112232,51780,2.167477791
731,LP6005441-DNA_C10,7,52155,139408,139408,0.37412,94575,44833,2.109495238
732,LP6005441-DNA_C10,8,49871,136973,136973,0.36409,90539,46434,1.949842788
733,LP6005441-DNA_C10,9,39302,105003,105003,0.37429,70209,34794,2.017847905
734,LP6005441-DNA_C10,MT,31,33,33,0.93939,31,2,15.5
735,LP6005441-DNA_C10,X,50078,51114,51114,0.97973,34237,16877,2.02861883
736,LP6005441-DNA_C10,Y,375,400,400,0.9375,244,156,1.564102564
737,LP6005441-DNA_C11,1,80639,189756,189756,0.42496,130800,58956,2.218603704
738,LP6005441-DNA_C11,10,51962,126079,126079,0.41214,86444,39635,2.18100164
739,LP6005441-DNA_C11,11,53950,128647,128647,0.41936,87237,41410,2.106665057
740,LP6005441-DNA_C11,12,46676,120082,120082,0.3887,82557,37525,2.200053298
741,LP6005441-DNA_C11,13,45262,101235,101235,0.4471,69001,32234,2.140627908
742,LP6005441-DNA_C11,14,37749,76945,76945,0.4906,52592,24353,2.159569663
743,LP6005441-DNA_C11,15,29169,72775,72775,0.40081,49659,23116,2.148252293
744,LP6005441-DNA_C11,16,29624,73402,73402,0.40359,47999,25403,1.88950124
745,LP6005441-DNA_C11,17,23409,62875,62875,0.37231,44453,18422,2.413038758
746,LP6005441-DNA_C11,18,30104,75553,75553,0.39845,51744,23809,2.173295813
747,LP6005441-DNA_C11,19,15066,43652,43652,0.34514,30839,12813,2.406852416
748,LP6005441-DNA_C11,2,85716,215797,215797,0.39721,146639,69158,2.12034761
749,LP6005441-DNA_C11,20,18555,52482,52482,0.35355,36605,15877,2.30553631
750,LP6005441-DNA_C11,21,15268,32549,32549,0.46908,22249,10300,2.160097087
751,LP6005441-DNA_C11,22,10240,30132,30132,0.33984,21262,8870,2.397068771
752,LP6005441-DNA_C11,3,70850,184573,184573,0.38386,124785,59788,2.087124507
753,LP6005441-DNA_C11,4,76842,193741,193741,0.39662,131010,62731,2.088441122
754,LP6005441-DNA_C11,5,63908,155183,155183,0.41182,104375,50808,2.054302472
755,LP6005441-DNA_C11,6,63676,161632,161632,0.39396,110700,50932,2.173486217
756,LP6005441-DNA_C11,7,54904,137419,137419,0.39954,93394,44025,2.121385576
757,LP6005441-DNA_C11,8,54411,136436,136436,0.3988,90108,46328,1.945000863
758,LP6005441-DNA_C11,9,40167,104247,104247,0.38531,69628,34619,2.01126549
759,LP6005441-DNA_C11,MT,33,35,35,0.94286,33,2,16.5
760,LP6005441-DNA_C11,X,49457,50705,50705,0.97539,33972,16733,2.030239646
761,LP6005441-DNA_C11,Y,686,742,742,0.92453,445,297,1.498316498
762,LP6005441-DNA_D01,1,77240,202271,202271,0.38186,139459,62812,2.22026046
763,LP6005441-DNA_D01,10,55000,126388,126388,0.43517,87196,39192,2.224841804
764,LP6005441-DNA_D01,11,54723,126433,126433,0.43282,85611,40822,2.097177992
765,LP6005441-DNA_D01,12,56596,115326,115326,0.49075,79193,36133,2.191708411
766,LP6005441-DNA_D01,13,50929,96987,96987,0.52511,66160,30827,2.146170565
767,LP6005441-DNA_D01,14,33222,79450,79450,0.41815,54305,25145,2.159673891
768,LP6005441-DNA_D01,15,43072,62113,62113,0.69345,42291,19822,2.133538493
769,LP6005441-DNA_D01,16,31429,75864,75864,0.41428,49695,26169,1.899002637
770,LP6005441-DNA_D01,17,22786,64383,64383,0.35391,45556,18827,2.419716365
771,LP6005441-DNA_D01,18,33666,72982,72982,0.46129,50001,22981,2.175753884
772,LP6005441-DNA_D01,19,18984,39559,39559,0.47989,27704,11855,2.33690426
773,LP6005441-DNA_D01,2,86959,217124,217124,0.4005,147516,69608,2.119239168
774,LP6005441-DNA_D01,20,21225,51892,51892,0.40902,36196,15696,2.30606524
775,LP6005441-DNA_D01,21,14995,36004,36004,0.41648,24653,11351,2.17187913
776,LP6005441-DNA_D01,22,9957,30923,30923,0.32199,21926,8997,2.437034567
777,LP6005441-DNA_D01,3,68612,191162,191162,0.35892,129382,61780,2.094237617
778,LP6005441-DNA_D01,4,80746,190102,190102,0.42475,128508,61594,2.086372049
779,LP6005441-DNA_D01,5,63538,162761,162761,0.39038,110268,52493,2.10062294
780,LP6005441-DNA_D01,6,61933,168450,168450,0.36766,115350,53100,2.172316384
781,LP6005441-DNA_D01,7,61430,130210,130210,0.47178,88483,41727,2.120521485
782,LP6005441-DNA_D01,8,50527,141499,141499,0.35708,93831,47668,1.968427457
783,LP6005441-DNA_D01,9,45317,106846,106846,0.42413,71420,35426,2.016033422
784,LP6005441-DNA_D01,MT,35,36,36,0.97222,NA,NA,NA
785,LP6005441-DNA_D01,X,48152,48802,48802,0.98668,32651,16151,2.021608569
786,LP6005441-DNA_D01,Y,970,1008,1008,0.9623,635,373,1.702412869
787,LP6005441-DNA_D02,1,79299,193689,193689,0.40941,133854,59835,2.237051893
788,LP6005441-DNA_D02,10,51494,125800,125800,0.40933,86597,39203,2.208938091
789,LP6005441-DNA_D02,11,52678,126958,126958,0.41492,86417,40541,2.131595175
790,LP6005441-DNA_D02,12,45251,120523,120523,0.37546,82989,37534,2.211035328
791,LP6005441-DNA_D02,13,44066,100054,100054,0.44042,68288,31766,2.149719826
792,LP6005441-DNA_D02,14,34161,80368,80368,0.42506,54972,25396,2.164592849
793,LP6005441-DNA_D02,15,31372,74312,74312,0.42217,50824,23488,2.163828338
794,LP6005441-DNA_D02,16,29240,73881,73881,0.39577,48619,25262,1.924590294
795,LP6005441-DNA_D02,17,25414,62057,62057,0.40953,43944,18113,2.426102799
796,LP6005441-DNA_D02,18,31933,75896,75896,0.42075,52080,23816,2.1867652
797,LP6005441-DNA_D02,19,15474,45877,45877,0.33729,32299,13578,2.378774488
798,LP6005441-DNA_D02,2,85493,211913,211913,0.40343,144238,67675,2.13133358
799,LP6005441-DNA_D02,20,19900,52542,52542,0.37874,36652,15890,2.30660793
800,LP6005441-DNA_D02,21,13348,35850,35850,0.37233,24486,11364,2.15469905
801,LP6005441-DNA_D02,22,9836,29346,29346,0.33517,20764,8582,2.419482638
802,LP6005441-DNA_D02,3,73001,181767,181767,0.40162,123050,58717,2.095645213
803,LP6005441-DNA_D02,4,76348,184912,184912,0.41289,125150,59762,2.094140089
804,LP6005441-DNA_D02,5,60127,156978,156978,0.38303,106244,50734,2.094138053
805,LP6005441-DNA_D02,6,63239,160658,160658,0.39362,110090,50568,2.177068502
806,LP6005441-DNA_D02,7,52388,138996,138996,0.3769,94631,44365,2.133010256
807,LP6005441-DNA_D02,8,51645,139021,139021,0.37149,92155,46866,1.966350873
808,LP6005441-DNA_D02,9,39589,105914,105914,0.37378,71103,34811,2.042544023
809,LP6005441-DNA_D02,MT,10,12,12,0.83333,11,1,11
810,LP6005441-DNA_D02,X,27101,68069,68069,0.39814,46047,22022,2.0909545
811,LP6005441-DNA_D03,1,77124,204854,204854,0.37648,141319,63535,2.224270087
812,LP6005441-DNA_D03,10,52187,134200,134200,0.38887,92444,41756,2.213909378
813,LP6005441-DNA_D03,11,53322,128026,128026,0.41649,86973,41053,2.118554064
814,LP6005441-DNA_D03,12,46993,123939,123939,0.37916,85180,38759,2.197683119
815,LP6005441-DNA_D03,13,42599,102970,102970,0.4137,70399,32571,2.161401247
816,LP6005441-DNA_D03,14,33872,84714,84714,0.39984,58005,26709,2.171739863
817,LP6005441-DNA_D03,15,30193,77184,77184,0.39118,52507,24677,2.127770799
818,LP6005441-DNA_D03,16,29950,78272,78272,0.38264,51400,26872,1.912771658
819,LP6005441-DNA_D03,17,23635,65217,65217,0.36241,46087,19130,2.409147935
820,LP6005441-DNA_D03,18,30875,78962,78962,0.39101,54138,24824,2.180873348
821,LP6005441-DNA_D03,19,14901,49263,49263,0.30248,34719,14544,2.387169967
822,LP6005441-DNA_D03,2,83917,215146,215146,0.39005,146327,68819,2.126258737
823,LP6005441-DNA_D03,20,20761,54749,54749,0.3792,38311,16438,2.33063633
824,LP6005441-DNA_D03,21,15205,36406,36406,0.41765,24842,11564,2.148218609
825,LP6005441-DNA_D03,22,10783,29967,29967,0.35983,21209,8758,2.421671615
826,LP6005441-DNA_D03,3,73018,186839,186839,0.39081,126373,60466,2.089984454
827,LP6005441-DNA_D03,4,76000,190719,190719,0.39849,129143,61576,2.0972944
828,LP6005441-DNA_D03,5,62174,164640,164640,0.37764,111383,53257,2.091424601
829,LP6005441-DNA_D03,6,59819,164270,164270,0.36415,112563,51707,2.176939293
830,LP6005441-DNA_D03,7,53674,145337,145337,0.36931,99142,46195,2.146163005
831,LP6005441-DNA_D03,8,52467,147747,147747,0.35511,98052,49695,1.973075762
832,LP6005441-DNA_D03,9,39639,109837,109837,0.36089,73486,36351,2.021567495
833,LP6005441-DNA_D03,MT,11,12,12,0.91667,11,1,11
834,LP6005441-DNA_D03,X,53298,54265,54265,0.98218,36428,17837,2.042271682
835,LP6005441-DNA_D03,Y,398,436,436,0.91284,264,172,1.534883721
836,LP6005441-DNA_D04,1,85468,192492,192492,0.44401,132725,59767,2.220707079
837,LP6005441-DNA_D04,10,56913,126454,126454,0.45007,87013,39441,2.206156031
838,LP6005441-DNA_D04,11,56223,127539,127539,0.44083,86641,40898,2.118465451
839,LP6005441-DNA_D04,12,50324,113918,113918,0.44176,78177,35741,2.187319885
840,LP6005441-DNA_D04,13,42695,97850,97850,0.43633,66787,31063,2.150049899
841,LP6005441-DNA_D04,14,34105,79670,79670,0.42808,54590,25080,2.176634769
842,LP6005441-DNA_D04,15,31298,73577,73577,0.42538,50003,23574,2.121108
843,LP6005441-DNA_D04,16,31901,73525,73525,0.43388,48242,25283,1.908080528
844,LP6005441-DNA_D04,17,25338,58464,58464,0.43339,41191,17273,2.384704452
845,LP6005441-DNA_D04,18,31849,76088,76088,0.41858,52272,23816,2.194827007
846,LP6005441-DNA_D04,19,16117,43763,43763,0.36828,30842,12921,2.386966953
847,LP6005441-DNA_D04,2,94723,210577,210577,0.44983,142981,67596,2.115228712
848,LP6005441-DNA_D04,20,23982,51757,51757,0.46336,36136,15621,2.313296204
849,LP6005441-DNA_D04,21,14209,34912,34912,0.40699,23743,11169,2.12579461
850,LP6005441-DNA_D04,22,12651,30354,30354,0.41678,21425,8929,2.399484825
851,LP6005441-DNA_D04,3,78178,182641,182641,0.42804,123355,59286,2.08067672
852,LP6005441-DNA_D04,4,85068,188364,188364,0.45161,127525,60839,2.096106116
853,LP6005441-DNA_D04,5,52753,128688,128688,0.40993,86734,41954,2.067359489
854,LP6005441-DNA_D04,6,79687,153035,153035,0.52071,104681,48354,2.164888117
855,LP6005441-DNA_D04,7,57758,137901,137901,0.41884,93759,44142,2.124031535
856,LP6005441-DNA_D04,8,57084,135275,135275,0.42198,89586,45689,1.960778306
857,LP6005441-DNA_D04,9,45659,105546,105546,0.4326,70492,35054,2.010954527
858,LP6005441-DNA_D04,MT,36,39,39,0.92308,37,2,18.5
859,LP6005441-DNA_D04,X,30435,69437,69437,0.43831,46833,22604,2.071889931
860,LP6005441-DNA_D05,1,87717,200139,200139,0.43828,138024,62115,2.222071963
861,LP6005441-DNA_D05,10,53082,128889,128889,0.41184,88818,40071,2.216515685
862,LP6005441-DNA_D05,11,57844,125340,125340,0.4615,85031,40309,2.109479273
863,LP6005441-DNA_D05,12,53042,122141,122141,0.43427,84169,37972,2.216606974
864,LP6005441-DNA_D05,13,43415,98191,98191,0.44215,67067,31124,2.154832284
865,LP6005441-DNA_D05,14,33235,83947,83947,0.3959,57634,26313,2.190324174
866,LP6005441-DNA_D05,15,31738,75147,75147,0.42235,51293,23854,2.15028926
867,LP6005441-DNA_D05,16,31267,74670,74670,0.41874,49136,25534,1.924336179
868,LP6005441-DNA_D05,17,24969,63142,63142,0.39544,44524,18618,2.391449135
869,LP6005441-DNA_D05,18,33572,74024,74024,0.45353,50703,23321,2.1741349
870,LP6005441-DNA_D05,19,18683,46965,46965,0.39781,33143,13822,2.397844017
871,LP6005441-DNA_D05,2,95674,211107,211107,0.4532,143701,67406,2.131872534
872,LP6005441-DNA_D05,20,22995,54510,54510,0.42185,37872,16638,2.276235124
873,LP6005441-DNA_D05,21,14001,35346,35346,0.39611,24172,11174,2.163236084
874,LP6005441-DNA_D05,22,13057,31540,31540,0.41398,22302,9238,2.414158909
875,LP6005441-DNA_D05,3,77327,180025,180025,0.42953,122079,57946,2.106771822
876,LP6005441-DNA_D05,4,78580,183601,183601,0.42799,124324,59277,2.097339609
877,LP6005441-DNA_D05,5,61980,152217,152217,0.40718,102798,49419,2.080131124
878,LP6005441-DNA_D05,6,69769,165597,165597,0.42132,113591,52006,2.184190286
879,LP6005441-DNA_D05,7,57365,140253,140253,0.40901,95468,44785,2.13169588
880,LP6005441-DNA_D05,8,58212,134236,134236,0.43365,89275,44961,1.985609751
881,LP6005441-DNA_D05,9,46269,106737,106737,0.43349,71676,35061,2.044322752
882,LP6005441-DNA_D05,MT,40,44,44,0.90909,39,5,7.8
883,LP6005441-DNA_D05,X,28446,64908,64908,0.43825,43859,21049,2.083661932
884,LP6005441-DNA_D06,1,86619,200327,200327,0.43239,138121,62206,2.220380671
885,LP6005441-DNA_D06,10,53035,129032,129032,0.41102,88909,40123,2.215911073
886,LP6005441-DNA_D06,11,57460,127797,127797,0.44962,86801,40996,2.117304127
887,LP6005441-DNA_D06,12,53948,123208,123208,0.43786,84898,38310,2.216079353
888,LP6005441-DNA_D06,13,47650,100922,100922,0.47215,68897,32025,2.151350507
889,LP6005441-DNA_D06,14,34615,83110,83110,0.4165,56755,26355,2.153481313
890,LP6005441-DNA_D06,15,30790,75088,75088,0.41005,51161,23927,2.138212062
891,LP6005441-DNA_D06,16,33156,75210,75210,0.44085,49280,25930,1.90050135
892,LP6005441-DNA_D06,17,24962,61004,61004,0.40919,43191,17813,2.424689833
893,LP6005441-DNA_D06,18,32911,78514,78514,0.41917,53786,24728,2.175105144
894,LP6005441-DNA_D06,19,16426,44564,44564,0.36859,31403,13161,2.386064889
895,LP6005441-DNA_D06,2,94447,216541,216541,0.43616,146860,69681,2.107604656
896,LP6005441-DNA_D06,20,22619,54431,54431,0.41555,38056,16375,2.324030534
897,LP6005441-DNA_D06,21,14434,34896,34896,0.41363,23851,11045,2.15943866
898,LP6005441-DNA_D06,22,11269,30245,30245,0.37259,21486,8759,2.453019751
899,LP6005441-DNA_D06,3,80708,185807,185807,0.43436,125659,60148,2.089163397
900,LP6005441-DNA_D06,4,86080,192400,192400,0.4474,130042,62358,2.085410052
901,LP6005441-DNA_D06,5,63312,156776,156776,0.40384,105826,50950,2.077055937
902,LP6005441-DNA_D06,6,69586,165833,165833,0.41961,113482,52351,2.167714084
903,LP6005441-DNA_D06,7,59926,140525,140525,0.42644,95614,44911,2.128966178
904,LP6005441-DNA_D06,8,57188,142522,142522,0.40126,94171,48351,1.947653616
905,LP6005441-DNA_D06,9,46037,108339,108339,0.42493,72282,36057,2.004659289
906,LP6005441-DNA_D06,MT,45,47,47,0.95745,46,1,46
907,LP6005441-DNA_D06,X,33248,70858,70858,0.46922,47624,23234,2.04975467
908,LP6005441-DNA_D07,1,88707,196637,196637,0.45112,135571,61066,2.220073363
909,LP6005441-DNA_D07,10,62722,124341,124341,0.50444,85410,38931,2.193881483
910,LP6005441-DNA_D07,11,48782,138475,138475,0.35228,94087,44388,2.119649455
911,LP6005441-DNA_D07,12,50381,120786,120786,0.41711,83075,37711,2.202938135
912,LP6005441-DNA_D07,13,47067,98327,98327,0.47868,67073,31254,2.146061304
913,LP6005441-DNA_D07,14,33034,85751,85751,0.38523,59086,26665,2.215863491
914,LP6005441-DNA_D07,15,32151,74422,74422,0.43201,50620,23802,2.126712041
915,LP6005441-DNA_D07,16,37027,71946,71946,0.51465,46997,24949,1.883722795
916,LP6005441-DNA_D07,17,27730,65189,65189,0.42538,46023,19166,2.401283523
917,LP6005441-DNA_D07,18,30078,78391,78391,0.38369,53865,24526,2.196240724
918,LP6005441-DNA_D07,19,19320,47318,47318,0.4083,33440,13878,2.409569102
919,LP6005441-DNA_D07,2,85423,220414,220414,0.38756,149945,70469,2.127815068
920,LP6005441-DNA_D07,20,22078,53445,53445,0.4131,37348,16097,2.320183885
921,LP6005441-DNA_D07,21,14265,39372,39372,0.36231,27044,12328,2.193705386
922,LP6005441-DNA_D07,22,10797,32955,32955,0.32763,23325,9630,2.42211838
923,LP6005441-DNA_D07,3,69929,189810,189810,0.36842,128349,61461,2.088299897
924,LP6005441-DNA_D07,4,75428,199680,199680,0.37774,135074,64606,2.090734607
925,LP6005441-DNA_D07,5,73583,149461,149461,0.49232,101138,48323,2.092957805
926,LP6005441-DNA_D07,6,75504,155729,155729,0.48484,106723,49006,2.177753744
927,LP6005441-DNA_D07,7,58832,138894,138894,0.42357,94771,44123,2.147882057
928,LP6005441-DNA_D07,8,57699,141090,141090,0.40895,93491,47599,1.964137902
929,LP6005441-DNA_D07,9,42923,108286,108286,0.39639,72611,35675,2.035346882
930,LP6005441-DNA_D07,MT,33,35,35,0.94286,34,1,34
931,LP6005441-DNA_D07,X,31329,75033,75033,0.41754,50724,24309,2.08663458
932,LP6005441-DNA_D08,1,84388,194815,194815,0.43317,133826,60989,2.19426454
933,LP6005441-DNA_D08,10,52503,124968,124968,0.42013,85593,39375,2.173790476
934,LP6005441-DNA_D08,11,53766,123670,123670,0.43475,83571,40099,2.084116811
935,LP6005441-DNA_D08,12,51801,119488,119488,0.43352,81928,37560,2.181256656
936,LP6005441-DNA_D08,13,47447,95909,95909,0.49471,65271,30638,2.130393629
937,LP6005441-DNA_D08,14,33661,81874,81874,0.41113,55508,26366,2.105287112
938,LP6005441-DNA_D08,15,32207,72691,72691,0.44307,49462,23229,2.129321107
939,LP6005441-DNA_D08,16,29798,70490,70490,0.42273,46004,24486,1.878787879
940,LP6005441-DNA_D08,17,25071,56788,56788,0.44148,39818,16970,2.346375958
941,LP6005441-DNA_D08,18,32899,75896,75896,0.43347,51963,23933,2.171186228
942,LP6005441-DNA_D08,19,14901,40609,40609,0.36694,28395,12214,2.324791223
943,LP6005441-DNA_D08,2,92054,207812,207812,0.44297,140645,67167,2.093959831
944,LP6005441-DNA_D08,20,21230,50949,50949,0.41669,35345,15604,2.265124327
945,LP6005441-DNA_D08,21,13814,35597,35597,0.38807,24269,11328,2.142390537
946,LP6005441-DNA_D08,22,10810,26547,26547,0.4072,18619,7928,2.348511604
947,LP6005441-DNA_D08,3,78510,183018,183018,0.42897,123447,59571,2.072266707
948,LP6005441-DNA_D08,4,88062,188572,188572,0.46699,127002,61570,2.062725353
949,LP6005441-DNA_D08,5,61334,153350,153350,0.39996,103463,49887,2.07394712
950,LP6005441-DNA_D08,6,68097,163794,163794,0.41575,111728,52066,2.145891753
951,LP6005441-DNA_D08,7,55534,137483,137483,0.40393,93272,44211,2.109701206
952,LP6005441-DNA_D08,8,57148,133067,133067,0.42947,88002,45065,1.952779319
953,LP6005441-DNA_D08,9,43869,102241,102241,0.42907,67937,34304,1.980439599
954,LP6005441-DNA_D08,MT,26,28,28,0.92857,27,1,27
955,LP6005441-DNA_D08,X,30236,69958,69958,0.4322,46953,23005,2.040991089
956,LP6005441-DNA_D09,1,78104,192423,192423,0.4059,132714,59709,2.222679998
957,LP6005441-DNA_D09,10,50313,130788,130788,0.38469,90159,40629,2.219079968
958,LP6005441-DNA_D09,11,49782,128152,128152,0.38846,87148,41004,2.125353624
959,LP6005441-DNA_D09,12,47481,120207,120207,0.39499,82561,37646,2.193088243
960,LP6005441-DNA_D09,13,43598,99923,99923,0.43632,68185,31738,2.148371038
961,LP6005441-DNA_D09,14,31350,83303,83303,0.37634,57092,26211,2.178169471
962,LP6005441-DNA_D09,15,31673,74222,74222,0.42673,50505,23717,2.129485179
963,LP6005441-DNA_D09,16,28539,72958,72958,0.39117,47906,25052,1.912262494
964,LP6005441-DNA_D09,17,23220,61158,61158,0.37967,43170,17988,2.399933289
965,LP6005441-DNA_D09,18,31450,75738,75738,0.41525,51982,23756,2.18816299
966,LP6005441-DNA_D09,19,16103,44535,44535,0.36158,31459,13076,2.405858061
967,LP6005441-DNA_D09,2,86302,214210,214210,0.40289,145496,68714,2.11741421
968,LP6005441-DNA_D09,20,19761,54984,54984,0.3594,38459,16525,2.327322239
969,LP6005441-DNA_D09,21,13707,36219,36219,0.37845,24755,11464,2.159368458
970,LP6005441-DNA_D09,22,9536,31168,31168,0.30595,22061,9107,2.422422313
971,LP6005441-DNA_D09,3,69404,181570,181570,0.38224,122805,58765,2.089764315
972,LP6005441-DNA_D09,4,77124,190911,190911,0.40398,129134,61777,2.090324878
973,LP6005441-DNA_D09,5,62211,159832,159832,0.38923,108079,51753,2.088362027
974,LP6005441-DNA_D09,6,58554,163811,163811,0.35745,112389,51422,2.18562094
975,LP6005441-DNA_D09,7,50142,137813,137813,0.36384,93776,44037,2.129482026
976,LP6005441-DNA_D09,8,52184,136609,136609,0.382,90601,46008,1.969244479
977,LP6005441-DNA_D09,9,40990,104578,104578,0.39196,69927,34651,2.018036997
978,LP6005441-DNA_D09,MT,34,37,37,0.91892,34,3,11.33333333
979,LP6005441-DNA_D09,X,26572,70042,70042,0.37937,47376,22666,2.090179123
980,LP6005441-DNA_D10,1,76665,201671,201671,0.38015,139374,62297,2.23725059
981,LP6005441-DNA_D10,10,50570,129713,129713,0.38986,89083,40630,2.192542456
982,LP6005441-DNA_D10,11,50234,132952,132952,0.37784,90246,42706,2.113192526
983,LP6005441-DNA_D10,12,47702,121801,121801,0.39164,83877,37924,2.211712899
984,LP6005441-DNA_D10,13,44333,101552,101552,0.43655,69132,32420,2.132387415
985,LP6005441-DNA_D10,14,32021,84287,84287,0.3799,57777,26510,2.17944172
986,LP6005441-DNA_D10,15,29812,75265,75265,0.39609,51212,24053,2.129131501
987,LP6005441-DNA_D10,16,28011,75989,75989,0.36862,49937,26052,1.916820206
988,LP6005441-DNA_D10,17,23054,64665,64665,0.35651,45685,18980,2.407007376
989,LP6005441-DNA_D10,18,31872,76559,76559,0.41631,52622,23937,2.198354013
990,LP6005441-DNA_D10,19,15636,45997,45997,0.33994,32397,13600,2.382132353
991,LP6005441-DNA_D10,2,85123,224598,224598,0.379,152704,71894,2.124015912
992,LP6005441-DNA_D10,20,21476,54988,54988,0.39056,38371,16617,2.309141241
993,LP6005441-DNA_D10,21,15299,39567,39567,0.38666,27007,12560,2.150238854
994,LP6005441-DNA_D10,22,10781,30814,30814,0.34987,21912,8902,2.461469333
995,LP6005441-DNA_D10,3,73299,188051,188051,0.38978,127199,60852,2.090301058
996,LP6005441-DNA_D10,4,75728,197223,197223,0.38397,133473,63750,2.093694118
997,LP6005441-DNA_D10,5,60276,163241,163241,0.36925,110584,52657,2.100081661
998,LP6005441-DNA_D10,6,61800,170088,170088,0.36334,116616,53472,2.180879713
999,LP6005441-DNA_D10,7,49913,146577,146577,0.34052,99851,46726,2.13694731
1000,LP6005441-DNA_D10,8,52516,141591,141591,0.3709,93718,47873,1.957637917
1001,LP6005441-DNA_D10,9,40757,110524,110524,0.36876,73917,36607,2.019203977
1002,LP6005441-DNA_D10,MT,30,34,34,0.88235,32,2,16
1003,LP6005441-DNA_D10,X,26966,74534,74534,0.36179,50209,24325,2.064090442
1004,LP6005441-DNA_D11,1,77084,189101,189101,0.40763,130677,58424,2.236700671
1005,LP6005441-DNA_D11,10,51376,128925,128925,0.3985,88864,40061,2.218217219
1006,LP6005441-DNA_D11,11,49541,127797,127797,0.38765,86901,40896,2.124926643
1007,LP6005441-DNA_D11,12,46872,125620,125620,0.37313,86491,39129,2.210406604
1008,LP6005441-DNA_D11,13,44565,101246,101246,0.44017,69057,32189,2.145360216
1009,LP6005441-DNA_D11,14,33874,79799,79799,0.42449,54504,25295,2.154734137
1010,LP6005441-DNA_D11,15,29675,71314,71314,0.41612,48610,22704,2.141032417
1011,LP6005441-DNA_D11,16,27433,71596,71596,0.38316,47123,24473,1.925509745
1012,LP6005441-DNA_D11,17,22165,57941,57941,0.38254,40891,17050,2.39829912
1013,LP6005441-DNA_D11,18,30724,76179,76179,0.40331,52214,23965,2.178760693
1014,LP6005441-DNA_D11,19,15117,41497,41497,0.36429,29235,12262,2.384195074
1015,LP6005441-DNA_D11,2,81524,208041,208041,0.39187,141496,66545,2.126320535
1016,LP6005441-DNA_D11,20,20829,51485,51485,0.40456,35915,15570,2.306679512
1017,LP6005441-DNA_D11,21,13856,35210,35210,0.39352,24086,11124,2.165228335
1018,LP6005441-DNA_D11,22,9782,27658,27658,0.35368,19593,8065,2.429386237
1019,LP6005441-DNA_D11,3,66349,182435,182435,0.36369,123230,59205,2.081412043
1020,LP6005441-DNA_D11,4,73351,189477,189477,0.38712,128099,61378,2.087050735
1021,LP6005441-DNA_D11,5,59863,161157,161157,0.37146,108865,52292,2.081867207
1022,LP6005441-DNA_D11,6,60816,161335,161335,0.37695,110540,50795,2.176198445
1023,LP6005441-DNA_D11,7,52112,136527,136527,0.3817,93315,43212,2.159469592
1024,LP6005441-DNA_D11,8,53692,140584,140584,0.38192,93278,47306,1.971800617
1025,LP6005441-DNA_D11,9,39914,104587,104587,0.38163,70019,34568,2.025543856
1026,LP6005441-DNA_D11,MT,10,12,12,0.83333,11,1,11
1027,LP6005441-DNA_D11,X,27133,75545,75545,0.35916,50878,24667,2.062593749
1028,LP6005441-DNA_D12,1,82817,192363,192363,0.43052,132589,59774,2.21817178
1029,LP6005441-DNA_D12,10,50794,124108,124108,0.40927,85419,38689,2.207836853
1030,LP6005441-DNA_D12,11,52483,119230,119230,0.44018,80950,38280,2.114681296
1031,LP6005441-DNA_D12,12,48954,116872,116872,0.41887,80338,36534,2.198992719
1032,LP6005441-DNA_D12,13,42931,96449,96449,0.44512,65870,30579,2.154092678
1033,LP6005441-DNA_D12,14,33843,81254,81254,0.41651,55653,25601,2.173860396
1034,LP6005441-DNA_D12,15,29502,72502,72502,0.40691,49268,23234,2.120513041
1035,LP6005441-DNA_D12,16,30613,70160,70160,0.43633,45928,24232,1.895344998
1036,LP6005441-DNA_D12,17,24754,57555,57555,0.43009,40542,17013,2.383001234
1037,LP6005441-DNA_D12,18,33197,74120,74120,0.44788,50713,23407,2.166574102
1038,LP6005441-DNA_D12,19,15205,39570,39570,0.38426,27913,11657,2.394526894
1039,LP6005441-DNA_D12,2,90085,208957,208957,0.43112,142053,66904,2.123236279
1040,LP6005441-DNA_D12,20,20696,52276,52276,0.3959,36419,15857,2.296714385
1041,LP6005441-DNA_D12,21,14422,33552,33552,0.42984,22872,10680,2.141573034
1042,LP6005441-DNA_D12,22,10919,27714,27714,0.39399,19578,8136,2.406342183
1043,LP6005441-DNA_D12,3,78264,179523,179523,0.43596,121322,58201,2.08453463
1044,LP6005441-DNA_D12,4,77695,186725,186725,0.41609,126128,60597,2.081423173
1045,LP6005441-DNA_D12,5,56891,153587,153587,0.37042,103946,49641,2.093954594
1046,LP6005441-DNA_D12,6,67268,167106,167106,0.40255,114424,52682,2.171975248
1047,LP6005441-DNA_D12,7,54960,137985,137985,0.3983,93840,44145,2.125722052
1048,LP6005441-DNA_D12,8,52755,132829,132829,0.39716,88126,44703,1.971366575
1049,LP6005441-DNA_D12,9,42042,104867,104867,0.40091,70136,34731,2.019406294
1050,LP6005441-DNA_D12,MT,40,43,43,0.93023,39,4,9.75
1051,LP6005441-DNA_D12,X,30081,69054,69054,0.43562,46578,22476,2.072343833
1052,LP6005441-DNA_E02,1,92825,184816,184816,0.50226,127522,57294,2.225747897
1053,LP6005441-DNA_E02,10,58730,119910,119910,0.48978,82578,37332,2.211989714
1054,LP6005441-DNA_E02,11,52795,128430,128430,0.41108,87308,41122,2.123145761
1055,LP6005441-DNA_E02,12,51755,119550,119550,0.43292,82235,37315,2.20380544
1056,LP6005441-DNA_E02,13,45053,101192,101192,0.44522,68876,32316,2.131328135
1057,LP6005441-DNA_E02,14,32375,84169,84169,0.38464,57514,26655,2.157719002
1058,LP6005441-DNA_E02,15,29657,77805,77805,0.38117,52996,24809,2.136160264
1059,LP6005441-DNA_E02,16,29862,74358,74358,0.4016,48947,25411,1.926213057
1060,LP6005441-DNA_E02,17,23368,64074,64074,0.3647,45371,18703,2.425867508
1061,LP6005441-DNA_E02,18,30848,75478,75478,0.4087,51883,23595,2.198898072
1062,LP6005441-DNA_E02,19,16731,45106,45106,0.37093,31739,13367,2.374429565
1063,LP6005441-DNA_E02,2,92816,216676,216676,0.42836,147171,69505,2.117416013
1064,LP6005441-DNA_E02,20,20681,56304,56304,0.36731,39311,16993,2.313364326
1065,LP6005441-DNA_E02,21,17206,34736,34736,0.49534,23690,11046,2.144667753
1066,LP6005441-DNA_E02,22,11713,30951,30951,0.37844,21975,8976,2.448195187
1067,LP6005441-DNA_E02,3,76012,188431,188431,0.40339,127561,60870,2.095630031
1068,LP6005441-DNA_E02,4,84424,192174,192174,0.43931,129983,62191,2.090061263
1069,LP6005441-DNA_E02,5,61734,165525,165525,0.37296,111949,53576,2.08953636
1070,LP6005441-DNA_E02,6,64240,164521,164521,0.39047,112803,51718,2.181116826
1071,LP6005441-DNA_E02,7,55175,142787,142787,0.38641,97393,45394,2.145503811
1072,LP6005441-DNA_E02,8,54992,145775,145775,0.37724,96640,49135,1.966826091
1073,LP6005441-DNA_E02,9,42724,109596,109596,0.38983,73252,36344,2.01551838
1074,LP6005441-DNA_E02,MT,20,22,22,0.90909,NA,NA,NA
1075,LP6005441-DNA_E02,X,51358,52092,52092,0.98591,35296,16796,2.101452727
1076,LP6005441-DNA_E02,Y,715,731,731,0.97811,457,274,1.667883212
1077,LP6005441-DNA_E03,1,78253,199675,199675,0.3919,137940,61735,2.23438892
1078,LP6005441-DNA_E03,10,48218,128062,128062,0.37652,88270,39792,2.218285082
1079,LP6005441-DNA_E03,11,49945,128519,128519,0.38862,87217,41302,2.111689507
1080,LP6005441-DNA_E03,12,47985,122491,122491,0.39174,84240,38251,2.202295365
1081,LP6005441-DNA_E03,13,40707,101728,101728,0.40016,69290,32438,2.136074974
1082,LP6005441-DNA_E03,14,31651,81501,81501,0.38835,55768,25733,2.167178331
1083,LP6005441-DNA_E03,15,28812,71563,71563,0.40261,48740,22823,2.135565
1084,LP6005441-DNA_E03,16,27677,77201,77201,0.35851,50788,26413,1.922841025
1085,LP6005441-DNA_E03,17,24555,61484,61484,0.39937,43494,17990,2.417676487
1086,LP6005441-DNA_E03,18,29770,76781,76781,0.38773,52689,24092,2.186991532
1087,LP6005441-DNA_E03,19,15037,45303,45303,0.33192,31950,13353,2.392720737
1088,LP6005441-DNA_E03,2,83572,219086,219086,0.38146,148506,70580,2.104080476
1089,LP6005441-DNA_E03,20,20707,54348,54348,0.38101,38049,16299,2.334437696
1090,LP6005441-DNA_E03,21,13377,37244,37244,0.35917,25404,11840,2.145608108
1091,LP6005441-DNA_E03,22,10246,30287,30287,0.3383,21503,8784,2.447973588
1092,LP6005441-DNA_E03,3,73301,181704,181704,0.40341,123013,58691,2.09594316
1093,LP6005441-DNA_E03,4,76987,192207,192207,0.40054,129737,62470,2.076788859
1094,LP6005441-DNA_E03,5,57937,158871,158871,0.36468,107089,51782,2.068073848
1095,LP6005441-DNA_E03,6,63147,165436,165436,0.3817,113301,52135,2.173223362
1096,LP6005441-DNA_E03,7,53918,141474,141474,0.38112,96302,45172,2.131895865
1097,LP6005441-DNA_E03,8,53939,135993,135993,0.39663,90063,45930,1.960875245
1098,LP6005441-DNA_E03,9,39497,108902,108902,0.36268,72791,36111,2.015756972
1099,LP6005441-DNA_E03,MT,47,49,49,0.95918,45,4,11.25
1100,LP6005441-DNA_E03,X,50711,51307,51307,0.98838,34432,16875,2.040414815
1101,LP6005441-DNA_E03,Y,707,727,727,0.97249,459,268,1.712686567
1102,LP6005441-DNA_E05,1,82172,202822,202822,0.40514,139659,63163,2.21108877
1103,LP6005441-DNA_E05,10,48598,132929,132929,0.36559,91569,41360,2.213950677
1104,LP6005441-DNA_E05,11,51310,130589,130589,0.39291,88562,42027,2.107264378
1105,LP6005441-DNA_E05,12,45564,122201,122201,0.37286,84167,38034,2.212941053
1106,LP6005441-DNA_E05,13,47903,94351,94351,0.50771,64295,30056,2.139173543
1107,LP6005441-DNA_E05,14,31677,85143,85143,0.37204,58268,26875,2.168111628
1108,LP6005441-DNA_E05,15,30718,75346,75346,0.40769,51352,23994,2.140201717
1109,LP6005441-DNA_E05,16,29515,75993,75993,0.38839,49744,26249,1.895081717
1110,LP6005441-DNA_E05,17,23366,61894,61894,0.37752,43709,18185,2.403574374
1111,LP6005441-DNA_E05,18,31648,76097,76097,0.41589,52300,23797,2.19775602
1112,LP6005441-DNA_E05,19,14924,44817,44817,0.333,31463,13354,2.356073087
1113,LP6005441-DNA_E05,2,93670,215394,215394,0.43488,146059,69335,2.106569554
1114,LP6005441-DNA_E05,20,20515,56474,56474,0.36326,39449,17025,2.31712188
1115,LP6005441-DNA_E05,21,12530,35294,35294,0.35502,24159,11135,2.169645263
1116,LP6005441-DNA_E05,22,13845,27377,27377,0.50572,19434,7943,2.446682614
1117,LP6005441-DNA_E05,3,70308,189450,189450,0.37112,128247,61203,2.095436498
1118,LP6005441-DNA_E05,4,76823,194361,194361,0.39526,131555,62806,2.094624717
1119,LP6005441-DNA_E05,5,55624,162558,162558,0.34218,109912,52646,2.087755955
1120,LP6005441-DNA_E05,6,64331,168677,168677,0.38139,115584,53093,2.177010152
1121,LP6005441-DNA_E05,7,55039,139612,139612,0.39423,95128,44484,2.138476756
1122,LP6005441-DNA_E05,8,55672,139166,139166,0.40004,92063,47103,1.954503959
1123,LP6005441-DNA_E05,9,51637,96760,96760,0.53366,64268,32492,1.977963806
1124,LP6005441-DNA_E05,MT,37,38,38,0.97368,NA,NA,NA
1125,LP6005441-DNA_E05,X,51103,51623,51623,0.98993,34734,16889,2.056604891
1126,LP6005441-DNA_E05,Y,988,1004,1004,0.98406,663,341,1.944281525
1127,LP6005441-DNA_E06,1,85962,193954,193954,0.44321,133682,60272,2.217978497
1128,LP6005441-DNA_E06,10,58263,119567,119567,0.48728,82178,37389,2.197919174
1129,LP6005441-DNA_E06,11,55471,123814,123814,0.44802,83864,39950,2.09922403
1130,LP6005441-DNA_E06,12,48084,120707,120707,0.39835,82881,37826,2.191111934
1131,LP6005441-DNA_E06,13,43628,103093,103093,0.42319,70255,32838,2.13944211
1132,LP6005441-DNA_E06,14,34021,82854,82854,0.41061,56770,26084,2.176429995
1133,LP6005441-DNA_E06,15,31265,73269,73269,0.42672,49905,23364,2.135978428
1134,LP6005441-DNA_E06,16,31238,73381,73381,0.4257,48030,25351,1.894599819
1135,LP6005441-DNA_E06,17,23245,63062,63062,0.36861,44528,18534,2.402503507
1136,LP6005441-DNA_E06,18,32299,75203,75203,0.42949,51806,23397,2.214215498
1137,LP6005441-DNA_E06,19,16077,41610,41610,0.38637,29329,12281,2.388160573
1138,LP6005441-DNA_E06,2,93238,208542,208542,0.44709,141901,66641,2.129334794
1139,LP6005441-DNA_E06,20,19403,54127,54127,0.35847,37756,16371,2.306273288
1140,LP6005441-DNA_E06,21,13355,37072,37072,0.36024,25365,11707,2.16665243
1141,LP6005441-DNA_E06,22,10166,29779,29779,0.34138,21039,8740,2.407208238
1142,LP6005441-DNA_E06,3,75434,181782,181782,0.41497,122823,58959,2.083193406
1143,LP6005441-DNA_E06,4,80097,192046,192046,0.41707,129693,62353,2.079980113
1144,LP6005441-DNA_E06,5,71345,151917,151917,0.46963,102897,49020,2.099082007
1145,LP6005441-DNA_E06,6,64182,164681,164681,0.38974,112791,51890,2.17365581
1146,LP6005441-DNA_E06,7,52419,139812,139812,0.37492,95133,44679,2.129255355
1147,LP6005441-DNA_E06,8,52109,137875,137875,0.37794,91553,46322,1.976447476
1148,LP6005441-DNA_E06,9,45354,102924,102924,0.44066,68810,34114,2.017060444
1149,LP6005441-DNA_E06,MT,41,43,43,0.95349,41,2,20.5
1150,LP6005441-DNA_E06,X,53703,54637,54637,0.98291,36608,18029,2.030506406
1151,LP6005441-DNA_E06,Y,714,757,757,0.9432,458,299,1.531772575
1152,LP6005441-DNA_E07,1,81076,240686,240686,0.33685,166446,74240,2.241998922
1153,LP6005441-DNA_E07,10,50750,152469,152469,0.33285,105165,47304,2.223173516
1154,LP6005441-DNA_E07,11,50764,153499,153499,0.33071,104697,48802,2.145342404
1155,LP6005441-DNA_E07,12,45022,139242,139242,0.32334,95984,43258,2.21887281
1156,LP6005441-DNA_E07,13,37423,110148,110148,0.33975,75126,35022,2.145108789
1157,LP6005441-DNA_E07,14,37337,98971,98971,0.37725,67679,31292,2.162821168
1158,LP6005441-DNA_E07,15,30002,88040,88040,0.34078,59893,28147,2.127864426
1159,LP6005441-DNA_E07,16,34004,99746,99746,0.34091,65700,34046,1.929742114
1160,LP6005441-DNA_E07,17,26436,80438,80438,0.32865,56911,23527,2.418965444
1161,LP6005441-DNA_E07,18,29440,87059,87059,0.33816,59675,27384,2.179192229
1162,LP6005441-DNA_E07,19,21591,62541,62541,0.34523,44076,18465,2.387002437
1163,LP6005441-DNA_E07,2,88091,259770,259770,0.33911,176973,82797,2.137432516
1164,LP6005441-DNA_E07,20,22975,70150,70150,0.32751,49050,21100,2.32464455
1165,LP6005441-DNA_E07,21,16459,45600,45600,0.36094,31233,14367,2.17394028
1166,LP6005441-DNA_E07,22,13930,40780,40780,0.34159,28981,11799,2.456225104
1167,LP6005441-DNA_E07,3,76034,224470,224470,0.33873,152025,72445,2.098488509
1168,LP6005441-DNA_E07,4,73625,215860,215860,0.34108,146109,69751,2.094722656
1169,LP6005441-DNA_E07,5,65832,201258,201258,0.3271,136386,64872,2.102386238
1170,LP6005441-DNA_E07,6,70134,196975,196975,0.35606,135072,61903,2.181994411
1171,LP6005441-DNA_E07,7,59686,172970,172970,0.34507,117814,55156,2.136014214
1172,LP6005441-DNA_E07,8,56247,170395,170395,0.3301,113462,56933,1.99290394
1173,LP6005441-DNA_E07,9,43448,130407,130407,0.33317,87468,42939,2.037029274
1174,LP6005441-DNA_E07,MT,60,66,66,0.90909,60,6,10
1175,LP6005441-DNA_E07,X,70629,71812,71812,0.98353,48311,23501,2.055699757
1176,LP6005441-DNA_E07,Y,967,1053,1053,0.91833,664,389,1.706940874
1177,LP6005441-DNA_E08,1,83747,192097,192097,0.43596,132100,59997,2.201776756
1178,LP6005441-DNA_E08,10,54275,125430,125430,0.43271,85980,39450,2.179467681
1179,LP6005441-DNA_E08,11,51915,125813,125813,0.41264,85164,40649,2.095106891
1180,LP6005441-DNA_E08,12,49524,116127,116127,0.42646,79612,36515,2.18025469
1181,LP6005441-DNA_E08,13,45589,100415,100415,0.45401,68244,32171,2.12128936
1182,LP6005441-DNA_E08,14,32810,80876,80876,0.40568,54947,25929,2.119133017
1183,LP6005441-DNA_E08,15,29536,71324,71324,0.41411,48415,22909,2.113361561
1184,LP6005441-DNA_E08,16,29852,72620,72620,0.41107,47306,25314,1.868768271
1185,LP6005441-DNA_E08,17,23985,57145,57145,0.41972,40104,17041,2.353383017
1186,LP6005441-DNA_E08,18,32000,75768,75768,0.42234,51851,23917,2.167955847
1187,LP6005441-DNA_E08,19,15321,40031,40031,0.38273,28052,11979,2.341764755
1188,LP6005441-DNA_E08,2,88758,207917,207917,0.42689,141028,66889,2.108388524
1189,LP6005441-DNA_E08,20,21603,51466,51466,0.41975,35797,15669,2.284574638
1190,LP6005441-DNA_E08,21,14179,34955,34955,0.40564,23704,11251,2.106834948
1191,LP6005441-DNA_E08,22,10026,28090,28090,0.35692,19814,8276,2.394151764
1192,LP6005441-DNA_E08,3,78390,181925,181925,0.43089,122593,59332,2.066220589
1193,LP6005441-DNA_E08,4,85848,189756,189756,0.45241,127685,62071,2.057079796
1194,LP6005441-DNA_E08,5,58476,158419,158419,0.36912,106629,51790,2.058872369
1195,LP6005441-DNA_E08,6,66736,161411,161411,0.41345,110153,51258,2.148991377
1196,LP6005441-DNA_E08,7,55581,137086,137086,0.40545,92876,44210,2.100791676
1197,LP6005441-DNA_E08,8,53340,137106,137106,0.38904,90464,46642,1.939539471
1198,LP6005441-DNA_E08,9,42899,103792,103792,0.41332,69241,34551,2.004023038
1199,LP6005441-DNA_E08,MT,35,37,37,0.94595,35,2,17.5
1200,LP6005441-DNA_E08,X,50640,52754,52754,0.95993,34782,17972,1.935343868
1201,LP6005441-DNA_E08,Y,612,719,719,0.85118,414,305,1.357377049
1202,LP6005441-DNA_E09,1,88663,191973,191973,0.46185,132249,59724,2.214335945
1203,LP6005441-DNA_E09,10,54811,124369,124369,0.44071,85479,38890,2.197968629
1204,LP6005441-DNA_E09,11,55488,121976,121976,0.45491,82670,39306,2.103241235
1205,LP6005441-DNA_E09,12,52879,114388,114388,0.46228,78658,35730,2.20145536
1206,LP6005441-DNA_E09,13,43693,98078,98078,0.44549,66684,31394,2.124100147
1207,LP6005441-DNA_E09,14,34797,81665,81665,0.42609,55933,25732,2.173674802
1208,LP6005441-DNA_E09,15,32949,72405,72405,0.45507,49138,23267,2.111918167
1209,LP6005441-DNA_E09,16,30608,73976,73976,0.41376,48536,25440,1.907861635
1210,LP6005441-DNA_E09,17,25581,58280,58280,0.43893,41148,17132,2.401821153
1211,LP6005441-DNA_E09,18,33269,73910,73910,0.45013,50665,23245,2.179608518
1212,LP6005441-DNA_E09,19,16467,44002,44002,0.37423,30867,13135,2.349980967
1213,LP6005441-DNA_E09,2,92715,212714,212714,0.43587,144377,68337,2.112720781
1214,LP6005441-DNA_E09,20,22109,52064,52064,0.42465,36307,15757,2.304182268
1215,LP6005441-DNA_E09,21,14647,34751,34751,0.42148,23675,11076,2.137504514
1216,LP6005441-DNA_E09,22,11544,28352,28352,0.40717,20091,8261,2.432030021
1217,LP6005441-DNA_E09,3,84402,176535,176535,0.4781,119423,57112,2.091031657
1218,LP6005441-DNA_E09,4,84973,186081,186081,0.45665,125661,60420,2.07979146
1219,LP6005441-DNA_E09,5,58458,151057,151057,0.38699,101830,49227,2.068580251
1220,LP6005441-DNA_E09,6,70731,158719,158719,0.44564,108667,50052,2.171082075
1221,LP6005441-DNA_E09,7,59576,140382,140382,0.42438,95644,44738,2.137869373
1222,LP6005441-DNA_E09,8,56124,134348,134348,0.41775,88970,45378,1.960641721
1223,LP6005441-DNA_E09,9,46409,103818,103818,0.44702,69509,34309,2.025969862
1224,LP6005441-DNA_E09,MT,41,43,43,0.95349,42,1,42
1225,LP6005441-DNA_E09,X,50852,51584,51584,0.98581,34617,16967,2.040254612
1226,LP6005441-DNA_E09,Y,687,734,734,0.93597,450,284,1.584507042
1227,LP6005441-DNA_E10,1,90576,193563,193563,0.46794,133488,60075,2.222022472
1228,LP6005441-DNA_E10,10,58400,126337,126337,0.46226,86814,39523,2.196543785
1229,LP6005441-DNA_E10,11,60423,122345,122345,0.49387,83138,39207,2.120488688
1230,LP6005441-DNA_E10,12,55511,116775,116775,0.47537,80215,36560,2.194064551
1231,LP6005441-DNA_E10,13,50823,97769,97769,0.51983,66554,31215,2.13211597
1232,LP6005441-DNA_E10,14,40679,79761,79761,0.51001,54416,25345,2.147011245
1233,LP6005441-DNA_E10,15,34864,70777,70777,0.49259,48254,22523,2.14243218
1234,LP6005441-DNA_E10,16,33848,71370,71370,0.47426,46889,24481,1.915322087
1235,LP6005441-DNA_E10,17,26581,58559,58559,0.45392,41333,17226,2.399454313
1236,LP6005441-DNA_E10,18,34775,72852,72852,0.47734,49941,22911,2.179782637
1237,LP6005441-DNA_E10,19,18197,43108,43108,0.42213,30290,12818,2.363083164
1238,LP6005441-DNA_E10,2,103796,205094,205094,0.50609,139076,66018,2.106637584
1239,LP6005441-DNA_E10,20,24666,50125,50125,0.49209,34967,15158,2.306834675
1240,LP6005441-DNA_E10,21,15791,34408,34408,0.45893,23531,10877,2.163372253
1241,LP6005441-DNA_E10,22,12153,27487,27487,0.44214,19575,7912,2.47408999
1242,LP6005441-DNA_E10,3,83844,180395,180395,0.46478,121693,58702,2.07306395
1243,LP6005441-DNA_E10,4,92983,182053,182053,0.51075,122813,59240,2.073143147
1244,LP6005441-DNA_E10,5,68575,150660,150660,0.45516,101533,49127,2.066745374
1245,LP6005441-DNA_E10,6,78640,154393,154393,0.50935,105327,49066,2.146639221
1246,LP6005441-DNA_E10,7,61160,136753,136753,0.44723,92919,43834,2.119792855
1247,LP6005441-DNA_E10,8,62124,130749,130749,0.47514,86796,43953,1.974745751
1248,LP6005441-DNA_E10,9,45474,108285,108285,0.41995,72306,35979,2.009672309
1249,LP6005441-DNA_E10,MT,44,48,48,0.91667,41,7,5.857142857
1250,LP6005441-DNA_E10,X,51609,52418,52418,0.98457,35242,17176,2.051816488
1251,LP6005441-DNA_E10,Y,477,498,498,0.95783,311,187,1.663101604
1252,LP6005441-DNA_F01,1,83706,235492,235492,0.35545,162426,73066,2.22300386
1253,LP6005441-DNA_F01,10,48499,156875,156875,0.30916,107693,49182,2.189683217
1254,LP6005441-DNA_F01,11,51507,151973,151973,0.33892,103464,48509,2.132882558
1255,LP6005441-DNA_F01,12,49980,140185,140185,0.35653,96495,43690,2.208628977
1256,LP6005441-DNA_F01,13,38824,117529,117529,0.33034,80216,37313,2.149813738
1257,LP6005441-DNA_F01,14,34349,100031,100031,0.34338,68560,31471,2.178513552
1258,LP6005441-DNA_F01,15,30940,88769,88769,0.34855,60226,28543,2.110009459
1259,LP6005441-DNA_F01,16,31016,95307,95307,0.32543,62573,32734,1.911559846
1260,LP6005441-DNA_F01,17,25974,78555,78555,0.33065,55290,23265,2.37653127
1261,LP6005441-DNA_F01,18,31221,91081,91081,0.34278,62429,28652,2.178870585
1262,LP6005441-DNA_F01,19,19328,59676,59676,0.32388,42033,17643,2.382417956
1263,LP6005441-DNA_F01,2,89837,264139,264139,0.34011,179623,84516,2.12531355
1264,LP6005441-DNA_F01,20,22434,70377,70377,0.31877,49010,21367,2.293723967
1265,LP6005441-DNA_F01,21,17847,44575,44575,0.40038,30552,14023,2.178706411
1266,LP6005441-DNA_F01,22,13582,36614,36614,0.37095,26001,10613,2.44991991
1267,LP6005441-DNA_F01,3,80946,225126,225126,0.35956,152266,72860,2.089843536
1268,LP6005441-DNA_F01,4,78502,230377,230377,0.34075,155550,74827,2.078795087
1269,LP6005441-DNA_F01,5,64856,207893,207893,0.31197,140683,67210,2.093185538
1270,LP6005441-DNA_F01,6,66013,201412,201412,0.32775,137942,63470,2.173341736
1271,LP6005441-DNA_F01,7,60845,179916,179916,0.33819,121913,58003,2.10183956
1272,LP6005441-DNA_F01,8,59815,181657,181657,0.32927,120847,60810,1.987288275
1273,LP6005441-DNA_F01,9,44291,132301,132301,0.33477,88850,43451,2.04483211
1274,LP6005441-DNA_F01,MT,42,43,43,0.97674,41,2,20.5
1275,LP6005441-DNA_F01,X,72701,73628,73628,0.98741,49512,24116,2.053076795
1276,LP6005441-DNA_F01,Y,946,983,983,0.96236,623,360,1.730555556
1277,LP6005441-DNA_F02,1,81072,202132,202132,0.40108,139854,62278,2.245640515
1278,LP6005441-DNA_F02,10,56597,130872,130872,0.43246,90151,40721,2.213869993
1279,LP6005441-DNA_F02,11,51265,130273,130273,0.39352,88646,41627,2.129531314
1280,LP6005441-DNA_F02,12,48716,122201,122201,0.39865,84117,38084,2.208722823
1281,LP6005441-DNA_F02,13,43334,97824,97824,0.44298,66683,31141,2.141324941
1282,LP6005441-DNA_F02,14,34437,82562,82562,0.4171,56649,25913,2.186122796
1283,LP6005441-DNA_F02,15,30947,77142,77142,0.40117,52503,24639,2.130890052
1284,LP6005441-DNA_F02,16,29275,79134,79134,0.36994,52071,27063,1.924066068
1285,LP6005441-DNA_F02,17,23500,63183,63183,0.37194,44751,18432,2.427897135
1286,LP6005441-DNA_F02,18,31382,77188,77188,0.40657,52979,24209,2.188401008
1287,LP6005441-DNA_F02,19,17151,49800,49800,0.3444,35075,14725,2.382003396
1288,LP6005441-DNA_F02,2,85783,218092,218092,0.39333,148507,69585,2.134181217
1289,LP6005441-DNA_F02,20,20334,58098,58098,0.34999,40554,17544,2.311559508
1290,LP6005441-DNA_F02,21,14304,38999,38999,0.36678,26763,12236,2.18723439
1291,LP6005441-DNA_F02,22,10871,34313,34313,0.31682,24351,9962,2.444388677
1292,LP6005441-DNA_F02,3,71703,186940,186940,0.38356,126558,60382,2.095955748
1293,LP6005441-DNA_F02,4,79836,189357,189357,0.42162,128352,61005,2.103958692
1294,LP6005441-DNA_F02,5,58603,164239,164239,0.35682,111426,52813,2.109821445
1295,LP6005441-DNA_F02,6,64086,164195,164195,0.3903,112365,51830,2.167952923
1296,LP6005441-DNA_F02,7,51224,146220,146220,0.35032,99768,46452,2.147765435
1297,LP6005441-DNA_F02,8,52311,142248,142248,0.36775,94311,47937,1.967394706
1298,LP6005441-DNA_F02,9,41862,109971,109971,0.38066,73892,36079,2.048061199
1299,LP6005441-DNA_F02,MT,42,44,44,0.95455,43,1,43
1300,LP6005441-DNA_F02,X,30145,73271,73271,0.41142,49556,23715,2.089647902
1301,LP6005441-DNA_F03,1,78328,198296,198296,0.39501,136923,61373,2.230997344
1302,LP6005441-DNA_F03,10,51196,130926,130926,0.39103,90002,40924,2.199247385
1303,LP6005441-DNA_F03,11,51405,127145,127145,0.4043,86547,40598,2.131804522
1304,LP6005441-DNA_F03,12,45915,119426,119426,0.38446,82177,37249,2.206153185
1305,LP6005441-DNA_F03,13,42431,101927,101927,0.41629,69505,32422,2.14376041
1306,LP6005441-DNA_F03,14,31309,82688,82688,0.37864,56351,26337,2.139613472
1307,LP6005441-DNA_F03,15,28286,73363,73363,0.38556,50002,23361,2.140404948
1308,LP6005441-DNA_F03,16,28505,76139,76139,0.37438,50100,26039,1.924037021
1309,LP6005441-DNA_F03,17,21642,62077,62077,0.34863,43857,18220,2.407080132
1310,LP6005441-DNA_F03,18,29746,77417,77417,0.38423,52998,24419,2.170359147
1311,LP6005441-DNA_F03,19,15260,45620,45620,0.3345,32056,13564,2.363314656
1312,LP6005441-DNA_F03,2,84332,216879,216879,0.38884,147423,69456,2.12253801
1313,LP6005441-DNA_F03,20,18644,54477,54477,0.34224,38096,16381,2.325621146
1314,LP6005441-DNA_F03,21,14448,34915,34915,0.4138,23870,11045,2.161158895
1315,LP6005441-DNA_F03,22,9565,28686,28686,0.33344,20432,8254,2.475405864
1316,LP6005441-DNA_F03,3,70502,187693,187693,0.37562,126909,60784,2.087868518
1317,LP6005441-DNA_F03,4,75086,194112,194112,0.38682,131113,62999,2.081191765
1318,LP6005441-DNA_F03,5,58278,161008,161008,0.36196,108711,52297,2.078723445
1319,LP6005441-DNA_F03,6,57127,165876,165876,0.3444,113657,52219,2.176544936
1320,LP6005441-DNA_F03,7,50179,139366,139366,0.36005,94795,44571,2.126831348
1321,LP6005441-DNA_F03,8,54638,137447,137447,0.39752,91019,46428,1.960433359
1322,LP6005441-DNA_F03,9,40371,107236,107236,0.37647,71662,35574,2.014448755
1323,LP6005441-DNA_F03,MT,36,38,38,0.94737,37,1,37
1324,LP6005441-DNA_F03,X,27053,74619,74619,0.36255,50519,24100,2.096224066
1325,LP6005441-DNA_F04,1,88512,200016,200016,0.44252,137772,62244,2.213418161
1326,LP6005441-DNA_F04,10,56252,127231,127231,0.44212,87615,39616,2.211606422
1327,LP6005441-DNA_F04,11,58853,127122,127122,0.46296,86257,40865,2.110779396
1328,LP6005441-DNA_F04,12,53024,123708,123708,0.42862,85142,38566,2.207695898
1329,LP6005441-DNA_F04,13,44900,103788,103788,0.43261,70690,33098,2.135778597
1330,LP6005441-DNA_F04,14,36803,82664,82664,0.44521,56571,26093,2.168052734
1331,LP6005441-DNA_F04,15,30881,74729,74729,0.41324,50917,23812,2.138291618
1332,LP6005441-DNA_F04,16,32281,74061,74061,0.43587,48490,25571,1.896288765
1333,LP6005441-DNA_F04,17,24546,62251,62251,0.39431,43851,18400,2.383206522
1334,LP6005441-DNA_F04,18,34666,78096,78096,0.44389,53647,24449,2.194241073
1335,LP6005441-DNA_F04,19,16388,44300,44300,0.36993,31165,13135,2.372668443
1336,LP6005441-DNA_F04,2,96469,214236,214236,0.45029,145395,68841,2.11204079
1337,LP6005441-DNA_F04,20,22366,55800,55800,0.40082,38892,16908,2.300212917
1338,LP6005441-DNA_F04,21,13496,36077,36077,0.37409,24608,11469,2.145609905
1339,LP6005441-DNA_F04,22,12573,30905,30905,0.40683,21820,9085,2.401761145
1340,LP6005441-DNA_F04,3,78621,186736,186736,0.42103,126215,60521,2.085474463
1341,LP6005441-DNA_F04,4,85149,192270,192270,0.44286,130089,62181,2.092102089
1342,LP6005441-DNA_F04,5,63507,156994,156994,0.40452,106154,50840,2.088001574
1343,LP6005441-DNA_F04,6,70502,169535,169535,0.41586,116225,53310,2.180172576
1344,LP6005441-DNA_F04,7,56279,143498,143498,0.39219,97561,45937,2.123799987
1345,LP6005441-DNA_F04,8,54246,140069,140069,0.38728,92711,47358,1.957662908
1346,LP6005441-DNA_F04,9,44492,109602,109602,0.40594,73080,36522,2.000985707
1347,LP6005441-DNA_F04,MT,39,41,41,0.95122,39,2,19.5
1348,LP6005441-DNA_F04,X,31151,72819,72819,0.42779,49223,23596,2.086073911
1349,LP6005441-DNA_F05,1,80743,199607,199607,0.40451,137735,61872,2.226128136
1350,LP6005441-DNA_F05,10,51169,133219,133219,0.3841,91747,41472,2.212263696
1351,LP6005441-DNA_F05,11,52625,129258,129258,0.40713,87724,41534,2.112100929
1352,LP6005441-DNA_F05,12,46862,123625,123625,0.37907,85081,38544,2.207373391
1353,LP6005441-DNA_F05,13,44107,102404,102404,0.43072,69920,32484,2.15244428
1354,LP6005441-DNA_F05,14,32146,86173,86173,0.37304,58931,27242,2.163240584
1355,LP6005441-DNA_F05,15,29209,75299,75299,0.38791,51411,23888,2.152168453
1356,LP6005441-DNA_F05,16,28568,76325,76325,0.37429,50182,26143,1.919519565
1357,LP6005441-DNA_F05,17,22664,61973,61973,0.36571,43797,18176,2.409606074
1358,LP6005441-DNA_F05,18,32297,78907,78907,0.4093,54131,24776,2.184815951
1359,LP6005441-DNA_F05,19,15060,45755,45755,0.32914,32121,13634,2.355948364
1360,LP6005441-DNA_F05,2,87121,217220,217220,0.40107,147719,69501,2.125422656
1361,LP6005441-DNA_F05,20,18703,53770,53770,0.34783,37481,16289,2.301000675
1362,LP6005441-DNA_F05,21,13512,35178,35178,0.3841,24040,11138,2.158376728
1363,LP6005441-DNA_F05,22,10194,28574,28574,0.35676,20164,8410,2.397621879
1364,LP6005441-DNA_F05,3,74191,185554,185554,0.39984,125621,59933,2.096023893
1365,LP6005441-DNA_F05,4,75248,192650,192650,0.39059,130190,62460,2.084373999
1366,LP6005441-DNA_F05,5,57541,162562,162562,0.35396,109805,52757,2.081335178
1367,LP6005441-DNA_F05,6,61076,168680,168680,0.36208,115725,52955,2.185346049
1368,LP6005441-DNA_F05,7,52104,141870,141870,0.36727,96751,45119,2.144351604
1369,LP6005441-DNA_F05,8,56053,141472,141472,0.39621,93734,47738,1.963509154
1370,LP6005441-DNA_F05,9,40573,109802,109802,0.36951,73670,36132,2.038912875
1371,LP6005441-DNA_F05,MT,17,21,21,0.80952,19,2,9.5
1372,LP6005441-DNA_F05,X,48652,49269,49269,0.98748,33132,16137,2.053169734
1373,LP6005441-DNA_F05,Y,645,673,673,0.9584,428,245,1.746938776
1374,LP6005441-DNA_F06,1,81804,199967,199967,0.40909,138021,61946,2.228085752
1375,LP6005441-DNA_F06,10,55006,131889,131889,0.41706,90771,41118,2.207573326
1376,LP6005441-DNA_F06,11,54037,128493,128493,0.42054,87362,41131,2.123994068
1377,LP6005441-DNA_F06,12,54061,124450,124450,0.4344,85660,38790,2.208301109
1378,LP6005441-DNA_F06,13,42783,98450,98450,0.43457,67293,31157,2.159803575
1379,LP6005441-DNA_F06,14,35049,85100,85100,0.41186,58452,26648,2.19348544
1380,LP6005441-DNA_F06,15,30603,75911,75911,0.40314,51800,24111,2.148396997
1381,LP6005441-DNA_F06,16,30496,82475,82475,0.36976,54246,28229,1.921640866
1382,LP6005441-DNA_F06,17,26194,68462,68462,0.38261,48442,20020,2.41968032
1383,LP6005441-DNA_F06,18,34252,71982,71982,0.47584,49580,22402,2.21319525
1384,LP6005441-DNA_F06,19,19827,49263,49263,0.40247,34839,14424,2.415349418
1385,LP6005441-DNA_F06,2,91835,209975,209975,0.43736,142848,67127,2.128025981
1386,LP6005441-DNA_F06,20,20006,57043,57043,0.35072,39916,17127,2.330589128
1387,LP6005441-DNA_F06,21,14998,36431,36431,0.41168,25047,11384,2.200193254
1388,LP6005441-DNA_F06,22,11445,33341,33341,0.34327,23654,9687,2.441829256
1389,LP6005441-DNA_F06,3,75045,183805,183805,0.40829,124592,59213,2.104132538
1390,LP6005441-DNA_F06,4,81763,186013,186013,0.43956,125895,60118,2.094131541
1391,LP6005441-DNA_F06,5,59704,160920,160920,0.37102,109075,51845,2.103867297
1392,LP6005441-DNA_F06,6,61135,162133,162133,0.37707,111076,51057,2.17552931
1393,LP6005441-DNA_F06,7,55351,144217,144217,0.3838,98427,45790,2.149530465
1394,LP6005441-DNA_F06,8,54865,140217,140217,0.39129,93134,47083,1.978081261
1395,LP6005441-DNA_F06,9,42732,112122,112122,0.38112,75096,37026,2.028196403
1396,LP6005441-DNA_F06,MT,26,28,28,0.92857,26,2,13
1397,LP6005441-DNA_F06,X,29604,74666,74666,0.39649,50518,24148,2.092015902
1398,LP6005441-DNA_F07,1,78514,234347,234347,0.33503,162207,72140,2.248502911
1399,LP6005441-DNA_F07,10,48570,149623,149623,0.32462,103130,46493,2.218183382
1400,LP6005441-DNA_F07,11,49316,152525,152525,0.32333,103782,48743,2.129167265
1401,LP6005441-DNA_F07,12,47515,142723,142723,0.33292,98140,44583,2.201287486
1402,LP6005441-DNA_F07,13,36503,112901,112901,0.32332,76978,35923,2.14286112
1403,LP6005441-DNA_F07,14,32866,98580,98580,0.33339,67346,31234,2.156175962
1404,LP6005441-DNA_F07,15,28589,88902,88902,0.32158,60573,28329,2.138197607
1405,LP6005441-DNA_F07,16,33786,94406,94406,0.35788,62255,32151,1.936331685
1406,LP6005441-DNA_F07,17,26168,74848,74848,0.34962,52850,21998,2.402491136
1407,LP6005441-DNA_F07,18,30010,87824,87824,0.34171,60283,27541,2.188845721
1408,LP6005441-DNA_F07,19,19728,59171,59171,0.33341,41622,17549,2.371759075
1409,LP6005441-DNA_F07,2,89108,258594,258594,0.34459,175952,82642,2.129086905
1410,LP6005441-DNA_F07,20,22326,69334,69334,0.32201,48452,20882,2.320275836
1411,LP6005441-DNA_F07,21,14943,44812,44812,0.33346,30861,13951,2.212099491
1412,LP6005441-DNA_F07,22,12978,38678,38678,0.33554,27525,11153,2.467945844
1413,LP6005441-DNA_F07,3,75876,226235,226235,0.33539,153090,73145,2.092966026
1414,LP6005441-DNA_F07,4,76811,225141,225141,0.34117,152149,72992,2.084461311
1415,LP6005441-DNA_F07,5,65053,199014,199014,0.32688,134585,64429,2.088888544
1416,LP6005441-DNA_F07,6,67523,199425,199425,0.33859,136847,62578,2.186822845
1417,LP6005441-DNA_F07,7,60881,173258,173258,0.35139,117660,55598,2.116263175
1418,LP6005441-DNA_F07,8,58984,175395,175395,0.33629,116585,58810,1.982400952
1419,LP6005441-DNA_F07,9,42974,128638,128638,0.33407,86315,42323,2.039434823
1420,LP6005441-DNA_F07,MT,36,38,38,0.94737,37,1,37
1421,LP6005441-DNA_F07,X,35772,104758,104758,0.34147,70731,34027,2.078672819
1422,LP6005441-DNA_F08,1,86425,199107,199107,0.43406,137097,62010,2.210885341
1423,LP6005441-DNA_F08,10,54981,127266,127266,0.43202,87493,39773,2.199808916
1424,LP6005441-DNA_F08,11,55676,128995,128995,0.43161,87569,41426,2.113865688
1425,LP6005441-DNA_F08,12,52736,120922,120922,0.43612,83186,37736,2.204420182
1426,LP6005441-DNA_F08,13,47631,103337,103337,0.46093,70590,32747,2.155617308
1427,LP6005441-DNA_F08,14,36104,82651,82651,0.43682,56494,26157,2.159804259
1428,LP6005441-DNA_F08,15,31612,75415,75415,0.41917,51200,24215,2.114391906
1429,LP6005441-DNA_F08,16,31686,74935,74935,0.42285,49087,25848,1.899063757
1430,LP6005441-DNA_F08,17,25496,62128,62128,0.41038,43776,18352,2.385353095
1431,LP6005441-DNA_F08,18,34165,78302,78302,0.43632,53644,24658,2.175521129
1432,LP6005441-DNA_F08,19,15601,44159,44159,0.35329,31112,13047,2.384609489
1433,LP6005441-DNA_F08,2,91257,216089,216089,0.42231,146769,69320,2.117267744
1434,LP6005441-DNA_F08,20,22582,54359,54359,0.41542,38014,16345,2.325726522
1435,LP6005441-DNA_F08,21,15254,35801,35801,0.42608,24474,11327,2.160678026
1436,LP6005441-DNA_F08,22,10994,29089,29089,0.37794,20569,8520,2.414201878
1437,LP6005441-DNA_F08,3,80667,186337,186337,0.43291,125984,60353,2.087452156
1438,LP6005441-DNA_F08,4,87428,192498,192498,0.45418,130076,62422,2.083816603
1439,LP6005441-DNA_F08,5,61499,158126,158126,0.38892,106655,51471,2.072137709
1440,LP6005441-DNA_F08,6,69011,164826,164826,0.41869,112964,51862,2.178165131
1441,LP6005441-DNA_F08,7,60642,139315,139315,0.43529,94475,44840,2.106935772
1442,LP6005441-DNA_F08,8,58741,140870,140870,0.41699,93373,47497,1.965871529
1443,LP6005441-DNA_F08,9,45738,109103,109103,0.41922,72811,36292,2.006254822
1444,LP6005441-DNA_F08,MT,43,44,44,0.97727,NA,NA,NA
1445,LP6005441-DNA_F08,X,29568,70398,70398,0.42001,47317,23081,2.050041159
1446,LP6005441-DNA_F09,1,87902,193481,193481,0.45432,133303,60178,2.21514507
1447,LP6005441-DNA_F09,10,58115,121569,121569,0.47804,83816,37753,2.220114958
1448,LP6005441-DNA_F09,11,56755,125358,125358,0.45274,84782,40576,2.089461751
1449,LP6005441-DNA_F09,12,51777,117018,117018,0.44247,80567,36451,2.210282297
1450,LP6005441-DNA_F09,13,44412,98454,98454,0.45109,66922,31532,2.122351896
1451,LP6005441-DNA_F09,14,33677,82257,82257,0.40941,56195,26062,2.156204436
1452,LP6005441-DNA_F09,15,31480,74039,74039,0.42518,50403,23636,2.132467423
1453,LP6005441-DNA_F09,16,29518,71886,71886,0.41062,47145,24741,1.905541409
1454,LP6005441-DNA_F09,17,25571,59625,59625,0.42886,42041,17584,2.390866697
1455,LP6005441-DNA_F09,18,33546,73856,73856,0.45421,50682,23174,2.187019936
1456,LP6005441-DNA_F09,19,17118,42571,42571,0.4021,30063,12508,2.403501759
1457,LP6005441-DNA_F09,2,96150,207893,207893,0.4625,141304,66589,2.122032167
1458,LP6005441-DNA_F09,20,22445,52368,52368,0.4286,36479,15889,2.295865064
1459,LP6005441-DNA_F09,21,15364,34117,34117,0.45033,23325,10792,2.161323202
1460,LP6005441-DNA_F09,22,12546,28926,28926,0.43373,20342,8584,2.369757689
1461,LP6005441-DNA_F09,3,82110,179962,179962,0.45626,121697,58265,2.088681026
1462,LP6005441-DNA_F09,4,86557,186297,186297,0.46462,125898,60399,2.084438484
1463,LP6005441-DNA_F09,5,61541,151856,151856,0.40526,102424,49432,2.072018126
1464,LP6005441-DNA_F09,6,70868,162324,162324,0.43658,111057,51267,2.166247294
1465,LP6005441-DNA_F09,7,59159,136162,136162,0.43448,92815,43347,2.141209311
1466,LP6005441-DNA_F09,8,56872,134622,134622,0.42246,89200,45422,1.963806085
1467,LP6005441-DNA_F09,9,45798,103454,103454,0.44269,69073,34381,2.009045694
1468,LP6005441-DNA_F09,MT,40,43,43,0.93023,42,1,42
1469,LP6005441-DNA_F09,X,31299,65344,65344,0.47899,44185,21159,2.088236684
1470,LP6005441-DNA_F10,1,92297,184751,184751,0.49958,126935,57816,2.195499516
1471,LP6005441-DNA_F10,10,56044,120768,120768,0.46406,82595,38173,2.163702093
1472,LP6005441-DNA_F10,11,57026,120009,120009,0.47518,81175,38834,2.090307463
1473,LP6005441-DNA_F10,12,60174,118256,118256,0.50885,80993,37263,2.17355017
1474,LP6005441-DNA_F10,13,51390,95007,95007,0.54091,64648,30359,2.129450904
1475,LP6005441-DNA_F10,14,36849,78871,78871,0.46721,53607,25264,2.121873021
1476,LP6005441-DNA_F10,15,34008,66295,66295,0.51298,45008,21287,2.114342087
1477,LP6005441-DNA_F10,16,34232,63573,63573,0.53847,41440,22133,1.872317354
1478,LP6005441-DNA_F10,17,24519,56001,56001,0.43783,39135,16866,2.32034863
1479,LP6005441-DNA_F10,18,37897,68075,68075,0.55669,46435,21640,2.145794824
1480,LP6005441-DNA_F10,19,20158,34294,34294,0.5878,23890,10404,2.296232218
1481,LP6005441-DNA_F10,2,100870,199588,199588,0.50539,134972,64616,2.088832487
1482,LP6005441-DNA_F10,20,22750,48274,48274,0.47127,33540,14734,2.276367585
1483,LP6005441-DNA_F10,21,16008,32745,32745,0.48887,22258,10487,2.122437303
1484,LP6005441-DNA_F10,22,12518,25191,25191,0.49692,17676,7515,2.352095808
1485,LP6005441-DNA_F10,3,84291,176146,176146,0.47853,118598,57548,2.060853548
1486,LP6005441-DNA_F10,4,105517,172366,172366,0.61217,115882,56484,2.051589831
1487,LP6005441-DNA_F10,5,69450,148684,148684,0.4671,99927,48757,2.04949033
1488,LP6005441-DNA_F10,6,73752,157723,157723,0.4676,107413,50310,2.135022858
1489,LP6005441-DNA_F10,7,64066,129538,129538,0.49457,87762,41776,2.100775565
1490,LP6005441-DNA_F10,8,65790,121507,121507,0.54145,80192,41315,1.940989955
1491,LP6005441-DNA_F10,9,51825,97780,97780,0.53002,64964,32816,1.979644076
1492,LP6005441-DNA_F10,MT,43,48,48,0.89583,41,7,5.857142857
1493,LP6005441-DNA_F10,X,37879,59913,59913,0.63223,40268,19645,2.04978366
1494,LP6005441-DNA_F12,1,82266,180763,180763,0.4551,124374,56389,2.205642945
1495,LP6005441-DNA_F12,10,49942,119734,119734,0.41711,82288,37446,2.197511083
1496,LP6005441-DNA_F12,11,53297,115236,115236,0.4625,78083,37153,2.1016607
1497,LP6005441-DNA_F12,12,53213,109097,109097,0.48776,74597,34500,2.162231884
1498,LP6005441-DNA_F12,13,43774,93714,93714,0.4671,63787,29927,2.131419788
1499,LP6005441-DNA_F12,14,30328,75673,75673,0.40078,51600,24073,2.143480248
1500,LP6005441-DNA_F12,15,41473,58928,58928,0.70379,39970,18958,2.108344762
1501,LP6005441-DNA_F12,16,29365,68766,68766,0.42703,44923,23843,1.884116932
1502,LP6005441-DNA_F12,17,22177,55444,55444,0.39999,39155,16289,2.403769415
1503,LP6005441-DNA_F12,18,31675,72678,72678,0.43583,49642,23036,2.154974822
1504,LP6005441-DNA_F12,19,13904,37892,37892,0.36694,26431,11461,2.306168746
1505,LP6005441-DNA_F12,2,86262,201065,201065,0.42903,136327,64738,2.105826562
1506,LP6005441-DNA_F12,20,19992,49245,49245,0.40597,34267,14978,2.287822139
1507,LP6005441-DNA_F12,21,13164,33382,33382,0.39434,22794,10588,2.152814507
1508,LP6005441-DNA_F12,22,10169,24745,24745,0.41095,17455,7290,2.394375857
1509,LP6005441-DNA_F12,3,75606,169950,169950,0.44487,114640,55310,2.072681251
1510,LP6005441-DNA_F12,4,79975,179415,179415,0.44575,120836,58579,2.062787006
1511,LP6005441-DNA_F12,5,58171,146309,146309,0.39759,98353,47956,2.050900826
1512,LP6005441-DNA_F12,6,66009,157470,157470,0.41918,107659,49811,2.161349903
1513,LP6005441-DNA_F12,7,54789,128246,128246,0.42722,87047,41199,2.112842545
1514,LP6005441-DNA_F12,8,53740,129567,129567,0.41477,85678,43889,1.95215202
1515,LP6005441-DNA_F12,9,43328,100479,100479,0.43121,67005,33474,2.001702814
1516,LP6005441-DNA_F12,MT,31,34,34,0.91176,33,1,33
1517,LP6005441-DNA_F12,X,30003,67181,67181,0.4466,45269,21912,2.065945601
1518,LP6005441-DNA_G02,1,93245,247907,247907,0.37613,171124,76783,2.228670409
1519,LP6005441-DNA_G02,10,57182,163471,163471,0.3498,112388,51083,2.20010571
1520,LP6005441-DNA_G02,11,52699,160455,160455,0.32843,109344,51111,2.139343781
1521,LP6005441-DNA_G02,12,51059,153871,153871,0.33183,105759,48112,2.198183405
1522,LP6005441-DNA_G02,13,38245,120881,120881,0.31639,82617,38264,2.159131298
1523,LP6005441-DNA_G02,14,35493,110706,110706,0.32061,75755,34951,2.16746302
1524,LP6005441-DNA_G02,15,31657,96402,96402,0.32839,65661,30741,2.135942227
1525,LP6005441-DNA_G02,16,33488,98972,98972,0.33836,65240,33732,1.93406854
1526,LP6005441-DNA_G02,17,26795,84188,84188,0.31828,59344,24844,2.388665271
1527,LP6005441-DNA_G02,18,30991,97124,97124,0.31909,66730,30394,2.195499112
1528,LP6005441-DNA_G02,19,20817,64116,64116,0.32468,45144,18972,2.379506641
1529,LP6005441-DNA_G02,2,91848,280614,280614,0.32731,190836,89778,2.125643253
1530,LP6005441-DNA_G02,20,26183,74483,74483,0.35153,52081,22402,2.324837068
1531,LP6005441-DNA_G02,21,16207,48570,48570,0.33368,33255,15315,2.171400588
1532,LP6005441-DNA_G02,22,14299,38822,38822,0.36832,27671,11151,2.481481481
1533,LP6005441-DNA_G02,3,84364,240911,240911,0.35019,163104,77807,2.096263832
1534,LP6005441-DNA_G02,4,83011,241989,241989,0.34304,163330,78659,2.076431178
1535,LP6005441-DNA_G02,5,73005,216182,216182,0.3377,146100,70082,2.084700779
1536,LP6005441-DNA_G02,6,70721,215272,215272,0.32852,147698,67574,2.185722319
1537,LP6005441-DNA_G02,7,62728,186331,186331,0.33665,126649,59682,2.122063604
1538,LP6005441-DNA_G02,8,69463,188640,188640,0.36823,125168,63472,1.972019158
1539,LP6005441-DNA_G02,9,46224,144759,144759,0.31932,96860,47899,2.022171653
1540,LP6005441-DNA_G02,MT,83,91,91,0.91209,87,4,21.75
1541,LP6005441-DNA_G02,X,78137,79031,79031,0.98869,53127,25904,2.050918777
1542,LP6005441-DNA_G02,Y,1287,1334,1334,0.96477,842,492,1.711382114
1543,LP6005441-DNA_G03,1,86420,204238,204238,0.42313,141075,63163,2.233506958
1544,LP6005441-DNA_G03,10,53736,128584,128584,0.41791,88543,40041,2.211308409
1545,LP6005441-DNA_G03,11,56259,126798,126798,0.44369,86391,40407,2.13802064
1546,LP6005441-DNA_G03,12,52179,124413,124413,0.4194,85788,38625,2.221048544
1547,LP6005441-DNA_G03,13,46302,101600,101600,0.45573,69362,32238,2.15156027
1548,LP6005441-DNA_G03,14,35971,83195,83195,0.43237,56826,26369,2.155030528
1549,LP6005441-DNA_G03,15,31619,77394,77394,0.40855,52728,24666,2.137679397
1550,LP6005441-DNA_G03,16,32533,78017,78017,0.417,51355,26662,1.926149576
1551,LP6005441-DNA_G03,17,26228,63882,63882,0.41057,45011,18871,2.385194213
1552,LP6005441-DNA_G03,18,32844,76565,76565,0.42897,52611,23954,2.196334641
1553,LP6005441-DNA_G03,19,16566,46816,46816,0.35385,32833,13983,2.348065508
1554,LP6005441-DNA_G03,2,91250,215792,215792,0.42286,146605,69187,2.118967436
1555,LP6005441-DNA_G03,20,22546,58091,58091,0.38812,40642,17449,2.329187919
1556,LP6005441-DNA_G03,21,13994,36544,36544,0.38294,25039,11505,2.176358105
1557,LP6005441-DNA_G03,22,12908,30758,30758,0.41966,21805,8953,2.435496482
1558,LP6005441-DNA_G03,3,80167,188238,188238,0.42588,127296,60942,2.08880575
1559,LP6005441-DNA_G03,4,83155,194035,194035,0.42856,131310,62725,2.093423675
1560,LP6005441-DNA_G03,5,62867,157080,157080,0.40022,106001,51079,2.075236399
1561,LP6005441-DNA_G03,6,71635,170618,170618,0.41986,117191,53427,2.193478953
1562,LP6005441-DNA_G03,7,58564,143141,143141,0.40914,97487,45654,2.13534411
1563,LP6005441-DNA_G03,8,59097,138632,138632,0.42629,91867,46765,1.964439217
1564,LP6005441-DNA_G03,9,46129,108885,108885,0.42365,72984,35901,2.032923874
1565,LP6005441-DNA_G03,MT,33,37,37,0.89189,36,1,36
1566,LP6005441-DNA_G03,X,53287,54063,54063,0.98565,36379,17684,2.057170323
1567,LP6005441-DNA_G03,Y,647,691,691,0.93632,432,259,1.667953668
1568,LP6005441-DNA_G04,1,80300,199118,199118,0.40328,137434,61684,2.228033201
1569,LP6005441-DNA_G04,10,50490,125290,125290,0.40299,86368,38922,2.219002107
1570,LP6005441-DNA_G04,11,52571,129073,129073,0.4073,87673,41400,2.117705314
1571,LP6005441-DNA_G04,12,47757,121257,121257,0.39385,83349,37908,2.198717949
1572,LP6005441-DNA_G04,13,43876,100137,100137,0.43816,68412,31725,2.156406619
1573,LP6005441-DNA_G04,14,31453,80626,80626,0.39011,55299,25327,2.183401113
1574,LP6005441-DNA_G04,15,35310,69543,69543,0.50774,47335,22208,2.131439121
1575,LP6005441-DNA_G04,16,35131,67837,67837,0.51787,44762,23075,1.939848321
1576,LP6005441-DNA_G04,17,21770,63470,63470,0.343,44839,18631,2.406687778
1577,LP6005441-DNA_G04,18,31710,75523,75523,0.41987,51848,23675,2.18998944
1578,LP6005441-DNA_G04,19,15931,44267,44267,0.35988,31203,13064,2.388472137
1579,LP6005441-DNA_G04,2,90434,204003,204003,0.4433,138677,65326,2.122845421
1580,LP6005441-DNA_G04,20,22618,50884,50884,0.4445,35525,15359,2.312976105
1581,LP6005441-DNA_G04,21,13275,35525,35525,0.37368,24247,11278,2.149937932
1582,LP6005441-DNA_G04,22,10221,29729,29729,0.34381,21138,8591,2.4604819
1583,LP6005441-DNA_G04,3,73407,180878,180878,0.40584,122534,58344,2.100198821
1584,LP6005441-DNA_G04,4,77692,188393,188393,0.41239,127795,60598,2.108897983
1585,LP6005441-DNA_G04,5,58782,156934,156934,0.37457,106404,50530,2.105758955
1586,LP6005441-DNA_G04,6,58903,162969,162969,0.36144,111826,51143,2.186535792
1587,LP6005441-DNA_G04,7,51984,142295,142295,0.36533,97008,45287,2.142071676
1588,LP6005441-DNA_G04,8,55188,138803,138803,0.3976,92131,46672,1.974010113
1589,LP6005441-DNA_G04,9,46162,101523,101523,0.45469,68330,33193,2.058566565
1590,LP6005441-DNA_G04,MT,10,12,12,0.83333,11,1,11
1591,LP6005441-DNA_G04,X,49443,49941,49941,0.99003,33697,16244,2.074427481
1592,LP6005441-DNA_G04,Y,712,734,734,0.97003,462,272,1.698529412
1593,LP6005441-DNA_G05,1,84320,188135,188135,0.44819,129185,58950,2.191433418
1594,LP6005441-DNA_G05,10,55680,126697,126697,0.43947,86981,39716,2.190074529
1595,LP6005441-DNA_G05,11,53852,128866,128866,0.41789,87321,41545,2.101841377
1596,LP6005441-DNA_G05,12,51219,121635,121635,0.42109,83429,38206,2.183662252
1597,LP6005441-DNA_G05,13,49184,105039,105039,0.46825,71477,33562,2.129700256
1598,LP6005441-DNA_G05,14,35572,82261,82261,0.43243,55906,26355,2.121267312
1599,LP6005441-DNA_G05,15,31222,73804,73804,0.42304,50163,23641,2.121864557
1600,LP6005441-DNA_G05,16,29491,67228,67228,0.43867,44049,23179,1.900383968
1601,LP6005441-DNA_G05,17,23000,51322,51322,0.44815,36055,15267,2.361629659
1602,LP6005441-DNA_G05,18,34882,77922,77922,0.44765,53282,24640,2.162418831
1603,LP6005441-DNA_G05,19,11925,32489,32489,0.36705,22712,9777,2.323002966
1604,LP6005441-DNA_G05,2,96679,213302,213302,0.45325,144587,68715,2.104154842
1605,LP6005441-DNA_G05,20,21255,52730,52730,0.40309,36659,16071,2.281065273
1606,LP6005441-DNA_G05,21,14729,34239,34239,0.43018,23267,10972,2.120579657
1607,LP6005441-DNA_G05,22,10700,24590,24590,0.43514,17318,7272,2.381463146
1608,LP6005441-DNA_G05,3,80032,188374,188374,0.42486,127028,61346,2.070681055
1609,LP6005441-DNA_G05,4,92032,197844,197844,0.46517,133622,64222,2.080626577
1610,LP6005441-DNA_G05,5,66844,161329,161329,0.41433,108487,52842,2.053044926
1611,LP6005441-DNA_G05,6,71898,162953,162953,0.44122,111555,51398,2.170415191
1612,LP6005441-DNA_G05,7,57842,140869,140869,0.41061,95455,45414,2.101884881
1613,LP6005441-DNA_G05,8,58018,141767,141767,0.40925,93492,48275,1.936654583
1614,LP6005441-DNA_G05,9,44728,105390,105390,0.4244,70163,35227,1.991739291
1615,LP6005441-DNA_G05,MT,44,48,48,0.91667,43,5,8.6
1616,LP6005441-DNA_G05,X,51449,52479,52479,0.98037,35223,17256,2.04120306
1617,LP6005441-DNA_G05,Y,631,657,657,0.96043,414,243,1.703703704
1618,LP6005441-DNA_G06,1,96188,191825,191825,0.50144,132228,59597,2.218702284
1619,LP6005441-DNA_G06,10,55121,121078,121078,0.45525,83202,37876,2.196694477
1620,LP6005441-DNA_G06,11,61321,120322,120322,0.50964,81448,38874,2.095179297
1621,LP6005441-DNA_G06,12,60062,108100,108100,0.55562,74133,33967,2.182500662
1622,LP6005441-DNA_G06,13,54491,93902,93902,0.5803,63963,29939,2.136444103
1623,LP6005441-DNA_G06,14,40025,78971,78971,0.50683,53876,25095,2.146881849
1624,LP6005441-DNA_G06,15,37271,70636,70636,0.52765,48187,22449,2.146509867
1625,LP6005441-DNA_G06,16,33944,70410,70410,0.48209,46117,24293,1.898365784
1626,LP6005441-DNA_G06,17,32008,54545,54545,0.58682,38456,16089,2.390204488
1627,LP6005441-DNA_G06,18,42981,67601,67601,0.6358,46322,21279,2.176888012
1628,LP6005441-DNA_G06,19,21124,37075,37075,0.56976,26078,10997,2.371374011
1629,LP6005441-DNA_G06,2,106323,200259,200259,0.53093,135875,64384,2.110384568
1630,LP6005441-DNA_G06,20,24864,49661,49661,0.50067,34629,15032,2.303685471
1631,LP6005441-DNA_G06,21,16112,34477,34477,0.46733,23569,10908,2.160707737
1632,LP6005441-DNA_G06,22,18427,23389,23389,0.78785,16517,6872,2.403521537
1633,LP6005441-DNA_G06,3,95372,171957,171957,0.55463,116026,55931,2.074448875
1634,LP6005441-DNA_G06,4,97358,178572,178572,0.5452,120748,57824,2.088198672
1635,LP6005441-DNA_G06,5,75418,142811,142811,0.5281,96188,46623,2.063101902
1636,LP6005441-DNA_G06,6,87719,149348,149348,0.58735,101893,47455,2.147149932
1637,LP6005441-DNA_G06,7,67597,131827,131827,0.51277,89853,41974,2.140682327
1638,LP6005441-DNA_G06,8,72212,122092,122092,0.59146,80750,41342,1.953219486
1639,LP6005441-DNA_G06,9,48623,102714,102714,0.47338,68804,33910,2.029017989
1640,LP6005441-DNA_G06,MT,35,39,39,0.89744,37,2,18.5
1641,LP6005441-DNA_G06,X,51423,52047,52047,0.98801,35067,16980,2.065194346
1642,LP6005441-DNA_G06,Y,502,518,518,0.96911,310,208,1.490384615
1643,LP6005441-DNA_G07,1,91078,192488,192488,0.47316,132809,59679,2.225389165
1644,LP6005441-DNA_G07,10,57520,123167,123167,0.46701,84664,38503,2.198893593
1645,LP6005441-DNA_G07,11,60763,121673,121673,0.4994,82478,39195,2.104299018
1646,LP6005441-DNA_G07,12,59391,119098,119098,0.49867,81720,37378,2.186312804
1647,LP6005441-DNA_G07,13,48603,96087,96087,0.50582,65614,30473,2.153184787
1648,LP6005441-DNA_G07,14,40613,79530,79530,0.51066,54321,25209,2.154825658
1649,LP6005441-DNA_G07,15,35783,69728,69728,0.51318,47535,22193,2.141891587
1650,LP6005441-DNA_G07,16,34011,72260,72260,0.47068,47345,24915,1.900260887
1651,LP6005441-DNA_G07,17,23965,60378,60378,0.39692,42555,17823,2.387645178
1652,LP6005441-DNA_G07,18,34366,72882,72882,0.47153,49927,22955,2.174994555
1653,LP6005441-DNA_G07,19,17877,43516,43516,0.41081,30599,12917,2.368893706
1654,LP6005441-DNA_G07,2,98270,206851,206851,0.47508,140396,66455,2.112647656
1655,LP6005441-DNA_G07,20,23769,52797,52797,0.4502,36867,15930,2.314312618
1656,LP6005441-DNA_G07,21,16560,33200,33200,0.4988,22684,10516,2.157093952
1657,LP6005441-DNA_G07,22,13681,28189,28189,0.48533,19940,8249,2.417262699
1658,LP6005441-DNA_G07,3,85893,176283,176283,0.48724,118891,57392,2.071560496
1659,LP6005441-DNA_G07,4,90506,186210,186210,0.48604,125737,60473,2.079225439
1660,LP6005441-DNA_G07,5,69077,152771,152771,0.45216,103229,49542,2.083666384
1661,LP6005441-DNA_G07,6,77526,157041,157041,0.49367,107526,49515,2.171584368
1662,LP6005441-DNA_G07,7,59844,137263,137263,0.43598,93610,43653,2.14441161
1663,LP6005441-DNA_G07,8,62084,132476,132476,0.46864,87559,44917,1.949351025
1664,LP6005441-DNA_G07,9,50272,102680,102680,0.4896,68761,33919,2.027211887
1665,LP6005441-DNA_G07,MT,33,34,34,0.97059,NA,NA,NA
1666,LP6005441-DNA_G07,X,31847,70038,70038,0.45471,47367,22671,2.089321159
1667,LP6005441-DNA_G08,1,78991,201117,201117,0.39276,138837,62280,2.229238921
1668,LP6005441-DNA_G08,10,48301,132853,132853,0.36357,91479,41374,2.211026248
1669,LP6005441-DNA_G08,11,51673,130914,130914,0.39471,88908,42006,2.116554778
1670,LP6005441-DNA_G08,12,46752,125791,125791,0.37166,86538,39253,2.204621303
1671,LP6005441-DNA_G08,13,43106,101875,101875,0.42313,69483,32392,2.145066683
1672,LP6005441-DNA_G08,14,38129,79061,79061,0.48227,54202,24859,2.180377328
1673,LP6005441-DNA_G08,15,29198,76936,76936,0.37951,52492,24444,2.147439044
1674,LP6005441-DNA_G08,16,27701,77856,77856,0.3558,51296,26560,1.931325301
1675,LP6005441-DNA_G08,17,24334,66133,66133,0.36796,46781,19352,2.417372881
1676,LP6005441-DNA_G08,18,30244,79626,79626,0.37983,54439,25187,2.161392782
1677,LP6005441-DNA_G08,19,15713,45443,45443,0.34577,32016,13427,2.384449244
1678,LP6005441-DNA_G08,2,83028,225240,225240,0.36862,153302,71938,2.131029498
1679,LP6005441-DNA_G08,20,18896,60651,60651,0.31155,42353,18298,2.314624549
1680,LP6005441-DNA_G08,21,14170,37752,37752,0.37534,25846,11906,2.170838233
1681,LP6005441-DNA_G08,22,9413,31131,31131,0.30237,22136,8995,2.460922735
1682,LP6005441-DNA_G08,3,76392,191785,191785,0.39832,129615,62170,2.084847997
1683,LP6005441-DNA_G08,4,75894,204032,204032,0.37197,137938,66094,2.086997307
1684,LP6005441-DNA_G08,5,59417,174451,174451,0.34059,117892,56559,2.084407433
1685,LP6005441-DNA_G08,6,62712,173263,173263,0.36195,118946,54317,2.189848482
1686,LP6005441-DNA_G08,7,53128,148781,148781,0.35709,101281,47500,2.132231579
1687,LP6005441-DNA_G08,8,52278,147661,147661,0.35404,97820,49841,1.962641199
1688,LP6005441-DNA_G08,9,40444,111220,111220,0.36364,74549,36671,2.032914292
1689,LP6005441-DNA_G08,MT,11,14,14,0.78571,13,1,13
1690,LP6005441-DNA_G08,X,52866,53617,53617,0.98599,36167,17450,2.07260745
1691,LP6005441-DNA_G08,Y,990,1006,1006,0.9841,628,378,1.661375661
1692,LP6005441-DNA_G09,1,79849,205092,205092,0.38933,141544,63548,2.2273557
1693,LP6005441-DNA_G09,10,52101,137264,137264,0.37957,94470,42794,2.207552461
1694,LP6005441-DNA_G09,11,52341,135605,135605,0.38598,92185,43420,2.123099954
1695,LP6005441-DNA_G09,12,47834,130274,130274,0.36718,89479,40795,2.193381542
1696,LP6005441-DNA_G09,13,44699,108255,108255,0.4129,73911,34344,2.152078966
1697,LP6005441-DNA_G09,14,34128,88481,88481,0.38571,60392,28089,2.150023141
1698,LP6005441-DNA_G09,15,32089,77043,77043,0.41651,52399,24644,2.126237624
1699,LP6005441-DNA_G09,16,30212,76142,76142,0.39678,49846,26296,1.895573471
1700,LP6005441-DNA_G09,17,23177,63205,63205,0.3667,44711,18494,2.417594896
1701,LP6005441-DNA_G09,18,30928,81923,81923,0.37753,56100,25823,2.172481896
1702,LP6005441-DNA_G09,19,16429,47705,47705,0.34439,33647,14058,2.393441457
1703,LP6005441-DNA_G09,2,93818,227852,227852,0.41175,154722,73130,2.115711746
1704,LP6005441-DNA_G09,20,20497,56124,56124,0.36521,39252,16872,2.326458037
1705,LP6005441-DNA_G09,21,14715,38474,38474,0.38247,26237,12237,2.144071259
1706,LP6005441-DNA_G09,22,10231,31252,31252,0.32737,22197,9055,2.451352844
1707,LP6005441-DNA_G09,3,73113,200448,200448,0.36475,135623,64825,2.092140378
1708,LP6005441-DNA_G09,4,79781,206813,206813,0.38576,139580,67233,2.076063838
1709,LP6005441-DNA_G09,5,61338,171015,171015,0.35867,115675,55340,2.09026021
1710,LP6005441-DNA_G09,6,62683,174402,174402,0.35942,119313,55089,2.165822578
1711,LP6005441-DNA_G09,7,53771,149644,149644,0.35933,101751,47893,2.124548473
1712,LP6005441-DNA_G09,8,54421,152380,152380,0.35714,101129,51251,1.973210279
1713,LP6005441-DNA_G09,9,42455,111673,111673,0.38017,74671,37002,2.018026053
1714,LP6005441-DNA_G09,MT,31,33,33,0.93939,32,1,32
1715,LP6005441-DNA_G09,X,1743,1826,1826,0.95455,1232,594,2.074074074
1716,LP6005441-DNA_G10,1,72316,183551,183551,0.39398,126087,57464,2.194191146
1717,LP6005441-DNA_G10,10,48586,127007,127007,0.38255,87172,39835,2.188326848
1718,LP6005441-DNA_G10,11,50618,124837,124837,0.40547,84665,40172,2.107562481
1719,LP6005441-DNA_G10,12,45453,118674,118674,0.38301,81197,37477,2.16658217
1720,LP6005441-DNA_G10,13,44385,102532,102532,0.43289,69654,32878,2.118559523
1721,LP6005441-DNA_G10,14,32119,78133,78133,0.41108,53045,25088,2.114357462
1722,LP6005441-DNA_G10,15,28827,73281,73281,0.39338,49633,23648,2.098824425
1723,LP6005441-DNA_G10,16,27307,73133,73133,0.37339,47792,25341,1.885955566
1724,LP6005441-DNA_G10,17,22634,61401,61401,0.36863,43048,18353,2.345556585
1725,LP6005441-DNA_G10,18,30069,76419,76419,0.39348,52233,24186,2.159637807
1726,LP6005441-DNA_G10,19,13869,41807,41807,0.33174,29238,12569,2.326199379
1727,LP6005441-DNA_G10,2,85481,219951,219951,0.38864,149090,70861,2.103978211
1728,LP6005441-DNA_G10,20,18310,52559,52559,0.34837,36487,16072,2.270221503
1729,LP6005441-DNA_G10,21,12148,34310,34310,0.35407,23300,11010,2.116257947
1730,LP6005441-DNA_G10,22,9113,28200,28200,0.32316,19957,8243,2.421084557
1731,LP6005441-DNA_G10,3,76485,171575,171575,0.44578,115702,55873,2.070803429
1732,LP6005441-DNA_G10,4,71989,182538,182538,0.39438,123164,59374,2.074375989
1733,LP6005441-DNA_G10,5,58539,161479,161479,0.36252,109075,52404,2.081425082
1734,LP6005441-DNA_G10,6,61580,163986,163986,0.37552,112026,51960,2.156004619
1735,LP6005441-DNA_G10,7,47727,131954,131954,0.36169,89491,42463,2.107505358
1736,LP6005441-DNA_G10,8,50156,130797,130797,0.38346,86263,44534,1.937014416
1737,LP6005441-DNA_G10,9,40810,104146,104146,0.39185,69310,34836,1.989608451
1738,LP6005441-DNA_G10,MT,12,16,16,0.75,15,1,15
1739,LP6005441-DNA_G10,X,49354,51934,51934,0.95032,33785,18149,1.861535071
1740,LP6005441-DNA_G10,Y,652,824,824,0.79126,436,388,1.12371134
1741,LP6005441-DNA_G11,1,84180,201670,201670,0.41741,139101,62569,2.22316163
1742,LP6005441-DNA_G11,10,53360,132730,132730,0.40202,91265,41465,2.201012902
1743,LP6005441-DNA_G11,11,53099,132727,132727,0.40006,90019,42708,2.107778402
1744,LP6005441-DNA_G11,12,60557,110654,110654,0.54726,76190,34464,2.210712628
1745,LP6005441-DNA_G11,13,44954,103199,103199,0.4356,70376,32823,2.144106267
1746,LP6005441-DNA_G11,14,34463,85285,85285,0.40409,58318,26967,2.162569066
1747,LP6005441-DNA_G11,15,33670,71138,71138,0.47331,48511,22627,2.143943077
1748,LP6005441-DNA_G11,16,28944,77970,77970,0.37122,51150,26820,1.907158837
1749,LP6005441-DNA_G11,17,25757,61916,61916,0.416,43771,18145,2.412289887
1750,LP6005441-DNA_G11,18,31785,76104,76104,0.41765,52193,23911,2.182802894
1751,LP6005441-DNA_G11,19,15960,45772,45772,0.34868,32265,13507,2.388761383
1752,LP6005441-DNA_G11,2,87887,219241,219241,0.40087,149027,70214,2.122468454
1753,LP6005441-DNA_G11,20,19359,56911,56911,0.34016,39675,17236,2.301868183
1754,LP6005441-DNA_G11,21,13419,37578,37578,0.3571,25643,11935,2.148554671
1755,LP6005441-DNA_G11,22,9797,31114,31114,0.31487,21997,9117,2.412745421
1756,LP6005441-DNA_G11,3,71556,188766,188766,0.37907,127988,60778,2.105827767
1757,LP6005441-DNA_G11,4,86839,184578,184578,0.47047,124907,59671,2.093261383
1758,LP6005441-DNA_G11,5,59557,163646,163646,0.36394,110454,53192,2.076515265
1759,LP6005441-DNA_G11,6,60899,169855,169855,0.35854,116235,53620,2.167754569
1760,LP6005441-DNA_G11,7,62818,134381,134381,0.46746,91413,42968,2.127466952
1761,LP6005441-DNA_G11,8,52809,141107,141107,0.37425,93660,47447,1.973992033
1762,LP6005441-DNA_G11,9,43293,104569,104569,0.41401,69938,34631,2.019520083
1763,LP6005441-DNA_G11,MT,33,36,36,0.91667,34,2,17
1764,LP6005441-DNA_G11,X,49440,50150,50150,0.98584,33672,16478,2.043451875
1765,LP6005441-DNA_G11,Y,361,387,387,0.93282,239,148,1.614864865
1766,LP6005441-DNA_G12,1,70384,179173,179173,0.39283,123276,55897,2.205413528
1767,LP6005441-DNA_G12,10,46370,121767,121767,0.38081,83802,37965,2.207348874
1768,LP6005441-DNA_G12,11,46950,119685,119685,0.39228,81093,38592,2.101290423
1769,LP6005441-DNA_G12,12,42777,113363,113363,0.37735,77825,35538,2.189909393
1770,LP6005441-DNA_G12,13,41798,95785,95785,0.43637,65216,30569,2.133403121
1771,LP6005441-DNA_G12,14,30726,75657,75657,0.40612,51881,23776,2.182074361
1772,LP6005441-DNA_G12,15,27668,68885,68885,0.40165,46916,21969,2.135554645
1773,LP6005441-DNA_G12,16,25322,67578,67578,0.37471,44265,23313,1.898726033
1774,LP6005441-DNA_G12,17,20593,55742,55742,0.36943,39410,16332,2.413054127
1775,LP6005441-DNA_G12,18,28446,71982,71982,0.39518,49338,22644,2.178855326
1776,LP6005441-DNA_G12,19,12556,37541,37541,0.33446,26451,11090,2.385121731
1777,LP6005441-DNA_G12,2,81345,206436,206436,0.39404,139929,66507,2.103974018
1778,LP6005441-DNA_G12,20,18699,48825,48825,0.38298,33963,14862,2.285224061
1779,LP6005441-DNA_G12,21,13176,34570,34570,0.38114,23565,11005,2.141299409
1780,LP6005441-DNA_G12,22,8604,25371,25371,0.33913,18012,7359,2.447615165
1781,LP6005441-DNA_G12,3,64049,171314,171314,0.37387,115719,55595,2.08146416
1782,LP6005441-DNA_G12,4,74636,181741,181741,0.41067,122799,58942,2.083387058
1783,LP6005441-DNA_G12,5,55848,152000,152000,0.36742,102468,49532,2.06872325
1784,LP6005441-DNA_G12,6,57975,154345,154345,0.37562,105631,48714,2.168391017
1785,LP6005441-DNA_G12,7,48737,130026,130026,0.37483,88403,41623,2.123897845
1786,LP6005441-DNA_G12,8,49137,131041,131041,0.37497,86503,44538,1.942229108
1787,LP6005441-DNA_G12,9,38389,99287,99287,0.38665,66444,32843,2.023079499
1788,LP6005441-DNA_G12,MT,32,34,34,0.94118,NA,NA,NA
1789,LP6005441-DNA_G12,X,44443,46278,46278,0.96035,30563,15715,1.94482978
1790,LP6005441-DNA_G12,Y,586,676,676,0.86686,368,308,1.194805195
1791,LP6005441-DNA_H02,1,84909,252236,252236,0.33663,174431,77805,2.241899621
1792,LP6005441-DNA_H02,10,54916,162673,162673,0.33759,111734,50939,2.193486327
1793,LP6005441-DNA_H02,11,49376,157146,157146,0.3142,107119,50027,2.141223739
1794,LP6005441-DNA_H02,12,51185,144612,144612,0.35395,99548,45064,2.209036038
1795,LP6005441-DNA_H02,13,40784,118429,118429,0.34438,80828,37601,2.14962368
1796,LP6005441-DNA_H02,14,37398,107835,107835,0.34681,73742,34093,2.162966005
1797,LP6005441-DNA_H02,15,30406,96785,96785,0.31416,65805,30980,2.124112331
1798,LP6005441-DNA_H02,16,32765,96833,96833,0.33837,63577,33256,1.911745249
1799,LP6005441-DNA_H02,17,28159,83234,83234,0.33831,58773,24461,2.402722701
1800,LP6005441-DNA_H02,18,34322,96557,96557,0.35546,65963,30594,2.156076355
1801,LP6005441-DNA_H02,19,23345,62658,62658,0.37258,44302,18356,2.413488778
1802,LP6005441-DNA_H02,2,97789,279816,279816,0.34948,190107,89709,2.119151925
1803,LP6005441-DNA_H02,20,24524,72779,72779,0.33697,50836,21943,2.316729709
1804,LP6005441-DNA_H02,21,17280,45783,45783,0.37743,31524,14259,2.210814223
1805,LP6005441-DNA_H02,22,14128,40445,40445,0.34931,28625,11820,2.421742809
1806,LP6005441-DNA_H02,3,82230,240784,240784,0.34151,163171,77613,2.102366872
1807,LP6005441-DNA_H02,4,88426,235217,235217,0.37593,159191,76026,2.093902086
1808,LP6005441-DNA_H02,5,71044,212842,212842,0.33379,144004,68838,2.091925971
1809,LP6005441-DNA_H02,6,72382,213830,213830,0.3385,146538,67292,2.177643702
1810,LP6005441-DNA_H02,7,60291,184444,184444,0.32688,125142,59302,2.110249233
1811,LP6005441-DNA_H02,8,64026,186486,186486,0.34333,123924,62562,1.980819028
1812,LP6005441-DNA_H02,9,46754,143411,143411,0.32601,96048,47363,2.027912083
1813,LP6005441-DNA_H02,MT,89,91,91,0.97802,84,7,12
1814,LP6005441-DNA_H02,X,80912,81808,81808,0.98905,54966,26842,2.047760972
1815,LP6005441-DNA_H02,Y,1319,1336,1336,0.98728,841,495,1.698989899
1816,LP6005441-DNA_H03,1,83034,195953,195953,0.42374,135170,60783,2.223812579
1817,LP6005441-DNA_H03,10,53315,126113,126113,0.42276,86833,39280,2.21061609
1818,LP6005441-DNA_H03,11,55356,125457,125457,0.44123,85170,40287,2.114081465
1819,LP6005441-DNA_H03,12,49732,122982,122982,0.40438,84757,38225,2.217318509
1820,LP6005441-DNA_H03,13,44418,98854,98854,0.44933,67367,31487,2.139517896
1821,LP6005441-DNA_H03,14,35069,82086,82086,0.42722,55918,26168,2.136884745
1822,LP6005441-DNA_H03,15,30877,72608,72608,0.42526,49428,23180,2.132355479
1823,LP6005441-DNA_H03,16,28697,74219,74219,0.38665,48611,25608,1.898273977
1824,LP6005441-DNA_H03,17,24997,57168,57168,0.43726,40209,16959,2.370953476
1825,LP6005441-DNA_H03,18,32334,75698,75698,0.42714,51895,23803,2.180187371
1826,LP6005441-DNA_H03,19,15133,41613,41613,0.36366,29252,12361,2.366475204
1827,LP6005441-DNA_H03,2,89978,215497,215497,0.41754,146498,68999,2.123190191
1828,LP6005441-DNA_H03,20,21374,54126,54126,0.39489,37763,16363,2.307828638
1829,LP6005441-DNA_H03,21,14385,36440,36440,0.39476,24882,11558,2.152794601
1830,LP6005441-DNA_H03,22,10955,27263,27263,0.40183,19250,8013,2.402346187
1831,LP6005441-DNA_H03,3,77180,187505,187505,0.41162,126798,60707,2.08868829
1832,LP6005441-DNA_H03,4,82081,193338,193338,0.42455,130684,62654,2.085804578
1833,LP6005441-DNA_H03,5,57534,155235,155235,0.37063,104593,50642,2.065341021
1834,LP6005441-DNA_H03,6,67789,170743,170743,0.39702,117053,53690,2.180163904
1835,LP6005441-DNA_H03,7,55058,138375,138375,0.39789,94108,44267,2.125917727
1836,LP6005441-DNA_H03,8,55391,139366,139366,0.39745,92133,47233,1.950606567
1837,LP6005441-DNA_H03,9,43199,107007,107007,0.4037,71543,35464,2.017341529
1838,LP6005441-DNA_H03,MT,35,37,37,0.94595,35,2,17.5
1839,LP6005441-DNA_H03,X,31907,73047,73047,0.4368,49220,23827,2.065723759
1840,LP6005441-DNA_H05,1,84726,197291,197291,0.42945,135902,61389,2.213784228
1841,LP6005441-DNA_H05,10,53423,128338,128338,0.41627,88462,39876,2.218427124
1842,LP6005441-DNA_H05,11,56151,125773,125773,0.44645,85346,40427,2.11111386
1843,LP6005441-DNA_H05,12,53336,122610,122610,0.43501,84326,38284,2.202643402
1844,LP6005441-DNA_H05,13,46108,100549,100549,0.45856,68522,32027,2.139507291
1845,LP6005441-DNA_H05,14,36326,84700,84700,0.42888,57811,26889,2.149986984
1846,LP6005441-DNA_H05,15,32031,75453,75453,0.42452,51338,24115,2.128882438
1847,LP6005441-DNA_H05,16,30380,73336,73336,0.41426,48085,25251,1.904281019
1848,LP6005441-DNA_H05,17,24486,60439,60439,0.40514,42561,17878,2.380635418
1849,LP6005441-DNA_H05,18,32776,79352,79352,0.41305,54327,25025,2.170909091
1850,LP6005441-DNA_H05,19,15213,41956,41956,0.36259,29594,12362,2.393949199
1851,LP6005441-DNA_H05,2,96575,212349,212349,0.45479,144117,68232,2.112161449
1852,LP6005441-DNA_H05,20,22397,54808,54808,0.40864,38431,16377,2.346644685
1853,LP6005441-DNA_H05,21,14704,34995,34995,0.42017,23930,11065,2.162675102
1854,LP6005441-DNA_H05,22,12871,29296,29296,0.43934,20714,8582,2.41365649
1855,LP6005441-DNA_H05,3,76686,184018,184018,0.41673,124457,59561,2.089572035
1856,LP6005441-DNA_H05,4,83744,188416,188416,0.44446,127111,61305,2.073419786
1857,LP6005441-DNA_H05,5,60939,152522,152522,0.39954,103046,49476,2.082747191
1858,LP6005441-DNA_H05,6,71450,161119,161119,0.44346,110349,50770,2.173507977
1859,LP6005441-DNA_H05,7,59259,142013,142013,0.41728,96651,45362,2.130660024
1860,LP6005441-DNA_H05,8,54758,139617,139617,0.3922,92383,47234,1.955858068
1861,LP6005441-DNA_H05,9,44808,105656,105656,0.42409,70452,35204,2.001249858
1862,LP6005441-DNA_H05,MT,40,43,43,0.93023,40,3,13.33333333
1863,LP6005441-DNA_H05,X,31877,71064,71064,0.44857,47943,23121,2.073569482
1864,LP6005441-DNA_H06,1,93589,187503,187503,0.49913,129427,58076,2.228579792
1865,LP6005441-DNA_H06,10,57641,119912,119912,0.48069,82347,37565,2.192120325
1866,LP6005441-DNA_H06,11,64085,114371,114371,0.56033,77617,36754,2.111797355
1867,LP6005441-DNA_H06,12,57541,109909,109909,0.52353,75555,34354,2.199307213
1868,LP6005441-DNA_H06,13,51535,93805,93805,0.54938,63956,29849,2.142651345
1869,LP6005441-DNA_H06,14,37983,79347,79347,0.47869,54400,24947,2.180622921
1870,LP6005441-DNA_H06,15,36481,68977,68977,0.52889,47019,21958,2.141315238
1871,LP6005441-DNA_H06,16,38480,65761,65761,0.58515,43070,22691,1.898109383
1872,LP6005441-DNA_H06,17,28816,57898,57898,0.4977,40785,17113,2.383275872
1873,LP6005441-DNA_H06,18,37754,69244,69244,0.54523,47448,21796,2.176913195
1874,LP6005441-DNA_H06,19,17109,40449,40449,0.42298,28457,11992,2.372998666
1875,LP6005441-DNA_H06,2,105820,197756,197756,0.5351,134412,63344,2.121937358
1876,LP6005441-DNA_H06,20,23044,50546,50546,0.4559,35414,15132,2.340338356
1877,LP6005441-DNA_H06,21,16870,33809,33809,0.49898,23071,10738,2.148537903
1878,LP6005441-DNA_H06,22,15066,27356,27356,0.55074,19357,7999,2.419927491
1879,LP6005441-DNA_H06,3,87331,167989,167989,0.51986,113397,54592,2.077172479
1880,LP6005441-DNA_H06,4,93044,177361,177361,0.5246,120065,57296,2.095521502
1881,LP6005441-DNA_H06,5,77943,136472,136472,0.57113,92176,44296,2.08091024
1882,LP6005441-DNA_H06,6,79914,152160,152160,0.5252,104068,48092,2.16393579
1883,LP6005441-DNA_H06,7,65717,129744,129744,0.50651,88324,41420,2.132399807
1884,LP6005441-DNA_H06,8,80653,109655,109655,0.73552,72283,37372,1.93414856
1885,LP6005441-DNA_H06,9,49736,99825,99825,0.49823,66780,33045,2.020880617
1886,LP6005441-DNA_H06,MT,35,37,37,0.94595,35,2,17.5
1887,LP6005441-DNA_H06,X,33916,66257,66257,0.51189,44642,21615,2.065325006
1888,LP6005441-DNA_H07,1,88204,190278,190278,0.46355,131300,58978,2.226253857
1889,LP6005441-DNA_H07,10,56982,121837,121837,0.46769,83803,38034,2.203370668
1890,LP6005441-DNA_H07,11,61718,119154,119154,0.51797,80803,38351,2.106933326
1891,LP6005441-DNA_H07,12,58183,114284,114284,0.50911,78439,35845,2.188282885
1892,LP6005441-DNA_H07,13,48642,95294,95294,0.51044,64925,30369,2.137870855
1893,LP6005441-DNA_H07,14,37509,81676,81676,0.45924,55953,25723,2.175212845
1894,LP6005441-DNA_H07,15,39286,66224,66224,0.59323,45075,21149,2.131306445
1895,LP6005441-DNA_H07,16,32642,70776,70776,0.4612,46510,24266,1.916673535
1896,LP6005441-DNA_H07,17,25678,58133,58133,0.44171,40929,17204,2.379039758
1897,LP6005441-DNA_H07,18,34465,71630,71630,0.48115,49163,22467,2.188231629
1898,LP6005441-DNA_H07,19,18297,40297,40297,0.45405,28305,11992,2.360323549
1899,LP6005441-DNA_H07,2,102347,200964,200964,0.50928,136212,64752,2.103595256
1900,LP6005441-DNA_H07,20,21917,51076,51076,0.42911,35726,15350,2.32742671
1901,LP6005441-DNA_H07,21,14901,35201,35201,0.42331,24090,11111,2.168121681
1902,LP6005441-DNA_H07,22,12443,27899,27899,0.446,19777,8122,2.434991381
1903,LP6005441-DNA_H07,3,84202,177905,177905,0.4733,120298,57607,2.088253164
1904,LP6005441-DNA_H07,4,86980,183950,183950,0.47285,124238,59712,2.080620311
1905,LP6005441-DNA_H07,5,70545,146983,146983,0.47995,99002,47981,2.063358413
1906,LP6005441-DNA_H07,6,80641,151100,151100,0.53369,103406,47694,2.16811339
1907,LP6005441-DNA_H07,7,62354,135262,135262,0.46099,91910,43352,2.120086732
1908,LP6005441-DNA_H07,8,62888,130930,130930,0.48032,86839,44091,1.969540269
1909,LP6005441-DNA_H07,9,48836,102441,102441,0.47672,68444,33997,2.013236462
1910,LP6005441-DNA_H07,MT,33,36,36,0.91667,32,4,8
1911,LP6005441-DNA_H07,X,35545,65258,65258,0.54468,43968,21290,2.065194927
1912,LP6005441-DNA_H08,1,74964,213600,213600,0.35096,147267,66333,2.220116684
1913,LP6005441-DNA_H08,10,48754,137053,137053,0.35573,94495,42558,2.220381597
1914,LP6005441-DNA_H08,11,50516,137896,137896,0.36633,93713,44183,2.121019397
1915,LP6005441-DNA_H08,12,50053,124707,124707,0.40136,85554,39153,2.185119914
1916,LP6005441-DNA_H08,13,40823,109473,109473,0.3729,74717,34756,2.149758315
1917,LP6005441-DNA_H08,14,34294,89228,89228,0.38434,60977,28251,2.158401473
1918,LP6005441-DNA_H08,15,28622,79254,79254,0.36114,53980,25274,2.135791723
1919,LP6005441-DNA_H08,16,28060,81015,81015,0.34636,53075,27940,1.899606299
1920,LP6005441-DNA_H08,17,21526,70859,70859,0.30379,50022,20837,2.400633489
1921,LP6005441-DNA_H08,18,30637,80202,80202,0.382,54921,25281,2.172421977
1922,LP6005441-DNA_H08,19,16697,47345,47345,0.35267,33320,14025,2.375757576
1923,LP6005441-DNA_H08,2,85677,228104,228104,0.3756,155370,72734,2.136139907
1924,LP6005441-DNA_H08,20,21172,61756,61756,0.34283,43094,18662,2.309184439
1925,LP6005441-DNA_H08,21,13684,39515,39515,0.3463,27025,12490,2.163730985
1926,LP6005441-DNA_H08,22,10220,32734,32734,0.31221,23191,9543,2.430158231
1927,LP6005441-DNA_H08,3,69625,197012,197012,0.3534,133293,63719,2.09188782
1928,LP6005441-DNA_H08,4,75185,199672,199672,0.37654,134659,65013,2.071262671
1929,LP6005441-DNA_H08,5,58219,180270,180270,0.32295,121895,58375,2.088137045
1930,LP6005441-DNA_H08,6,60269,177622,177622,0.33931,122003,55619,2.193548967
1931,LP6005441-DNA_H08,7,52697,158047,158047,0.33343,107407,50640,2.120991311
1932,LP6005441-DNA_H08,8,58268,148470,148470,0.39246,98308,50162,1.959810215
1933,LP6005441-DNA_H08,9,39444,119539,119539,0.32997,80132,39407,2.033445834
1934,LP6005441-DNA_H08,MT,28,30,30,0.93333,27,3,9
1935,LP6005441-DNA_H08,X,27501,84754,84754,0.32448,57152,27602,2.070574596
1936,LP6005441-DNA_H09,1,74105,192293,192293,0.38538,132562,59731,2.219316603
1937,LP6005441-DNA_H09,10,50827,128089,128089,0.39681,88047,40042,2.19886619
1938,LP6005441-DNA_H09,11,50476,123854,123854,0.40754,83986,39868,2.106601786
1939,LP6005441-DNA_H09,12,45544,118408,118408,0.38464,81455,36953,2.204286526
1940,LP6005441-DNA_H09,13,44694,99375,99375,0.44975,67515,31860,2.119114878
1941,LP6005441-DNA_H09,14,31363,80057,80057,0.39176,54683,25374,2.155080003
1942,LP6005441-DNA_H09,15,29645,71260,71260,0.41601,48604,22656,2.145303672
1943,LP6005441-DNA_H09,16,30996,69426,69426,0.44646,45329,24097,1.881105532
1944,LP6005441-DNA_H09,17,22103,59034,59034,0.37441,41732,17302,2.411975494
1945,LP6005441-DNA_H09,18,29370,75716,75716,0.3879,51910,23806,2.18054272
1946,LP6005441-DNA_H09,19,13695,44147,44147,0.31021,31099,13048,2.383430411
1947,LP6005441-DNA_H09,2,80833,215014,215014,0.37594,145941,69073,2.112851621
1948,LP6005441-DNA_H09,20,18999,51099,51099,0.37181,35510,15589,2.277888255
1949,LP6005441-DNA_H09,21,13854,35147,35147,0.39417,24007,11140,2.15502693
1950,LP6005441-DNA_H09,22,8697,29256,29256,0.29727,20732,8524,2.432191459
1951,LP6005441-DNA_H09,3,71399,187170,187170,0.38147,126596,60574,2.089939578
1952,LP6005441-DNA_H09,4,72359,190419,190419,0.38,128716,61703,2.086057404
1953,LP6005441-DNA_H09,5,58768,160285,160285,0.36665,108034,52251,2.067596792
1954,LP6005441-DNA_H09,6,59514,160730,160730,0.37027,110212,50518,2.181638228
1955,LP6005441-DNA_H09,7,49771,139405,139405,0.35702,94679,44726,2.116867147
1956,LP6005441-DNA_H09,8,49938,144020,144020,0.34674,95296,48724,1.955832854
1957,LP6005441-DNA_H09,9,40315,105062,105062,0.38373,70209,34853,2.014432043
1958,LP6005441-DNA_H09,MT,9,12,12,0.75,11,1,11
1959,LP6005441-DNA_H09,X,25278,71783,71783,0.35214,48440,23343,2.075140299
1960,LP6005441-DNA_H10,1,80776,202274,202274,0.39934,139429,62845,2.218617233
1961,LP6005441-DNA_H10,10,51681,133148,133148,0.38815,91668,41480,2.209932498
1962,LP6005441-DNA_H10,11,51156,131696,131696,0.38844,89626,42070,2.130401711
1963,LP6005441-DNA_H10,12,48043,120988,120988,0.39709,83308,37680,2.210934183
1964,LP6005441-DNA_H10,13,44481,100301,100301,0.44348,68372,31929,2.141376178
1965,LP6005441-DNA_H10,14,34211,85099,85099,0.40201,58224,26875,2.166474419
1966,LP6005441-DNA_H10,15,31210,76593,76593,0.40748,52156,24437,2.134304538
1967,LP6005441-DNA_H10,16,30042,78716,78716,0.38165,51988,26728,1.945076324
1968,LP6005441-DNA_H10,17,24618,64135,64135,0.38385,45309,18826,2.406724742
1969,LP6005441-DNA_H10,18,31743,77913,77913,0.40742,53456,24457,2.185713702
1970,LP6005441-DNA_H10,19,16195,47366,47366,0.34191,33349,14017,2.379182421
1971,LP6005441-DNA_H10,2,86345,222167,222167,0.38865,151405,70762,2.139637093
1972,LP6005441-DNA_H10,20,20062,56991,56991,0.35202,39952,17039,2.344738541
1973,LP6005441-DNA_H10,21,14082,35753,35753,0.39387,24472,11281,2.169311231
1974,LP6005441-DNA_H10,22,10408,30337,30337,0.34308,21590,8747,2.468274837
1975,LP6005441-DNA_H10,3,68823,186975,186975,0.36809,126493,60482,2.091415628
1976,LP6005441-DNA_H10,4,78982,189460,189460,0.41688,128156,61304,2.090499804
1977,LP6005441-DNA_H10,5,61941,158571,158571,0.39062,107255,51316,2.090088861
1978,LP6005441-DNA_H10,6,61906,164655,164655,0.37597,112923,51732,2.182846207
1979,LP6005441-DNA_H10,7,51770,142931,142931,0.3622,97525,45406,2.147843897
1980,LP6005441-DNA_H10,8,52336,138674,138674,0.3774,91947,46727,1.967748839
1981,LP6005441-DNA_H10,9,41612,108153,108153,0.38475,72451,35702,2.029326088
1982,LP6005441-DNA_H10,MT,34,37,37,0.91892,36,1,36
1983,LP6005441-DNA_H10,X,26326,71708,71708,0.36713,48379,23329,2.073770843
1984,LP6005441-DNA_H11,1,79754,202191,202191,0.39445,139696,62495,2.235314825
1985,LP6005441-DNA_H11,10,50015,130328,130328,0.38376,89586,40742,2.198861126
1986,LP6005441-DNA_H11,11,51177,129786,129786,0.39432,88012,41774,2.106860727
1987,LP6005441-DNA_H11,12,49839,124350,124350,0.4008,85669,38681,2.214756599
1988,LP6005441-DNA_H11,13,40182,105680,105680,0.38022,72077,33603,2.144957295
1989,LP6005441-DNA_H11,14,34249,84700,84700,0.40436,57914,26786,2.162099604
1990,LP6005441-DNA_H11,15,31094,75529,75529,0.41168,51409,24120,2.131384743
1991,LP6005441-DNA_H11,16,28813,76619,76619,0.37606,50125,26494,1.891937797
1992,LP6005441-DNA_H11,17,21969,59993,59993,0.36619,42144,17849,2.36114068
1993,LP6005441-DNA_H11,18,32250,77317,77317,0.41711,53160,24157,2.20060438
1994,LP6005441-DNA_H11,19,14788,43798,43798,0.33764,30979,12819,2.416647164
1995,LP6005441-DNA_H11,2,83863,221017,221017,0.37944,150196,70821,2.120783383
1996,LP6005441-DNA_H11,20,20034,55280,55280,0.36241,38530,16750,2.300298507
1997,LP6005441-DNA_H11,21,14564,36900,36900,0.39469,25220,11680,2.159246575
1998,LP6005441-DNA_H11,22,10738,29700,29700,0.36155,21024,8676,2.423236515
1999,LP6005441-DNA_H11,3,72927,192191,192191,0.37945,129805,62386,2.080675151
2000,LP6005441-DNA_H11,4,78596,197812,197812,0.39733,133752,64060,2.087917577
2001,LP6005441-DNA_H11,5,60538,164957,164957,0.36699,111526,53431,2.08729015
2002,LP6005441-DNA_H11,6,59058,166356,166356,0.35501,113704,52652,2.159538099
2003,LP6005441-DNA_H11,7,53235,143220,143220,0.3717,97693,45527,2.145825554
2004,LP6005441-DNA_H11,8,54367,141394,141394,0.38451,93691,47703,1.964048383
2005,LP6005441-DNA_H11,9,40922,109383,109383,0.37412,73342,36041,2.034960184
2006,LP6005441-DNA_H11,MT,31,34,34,0.91176,NA,NA,NA
2007,LP6005441-DNA_H11,X,25127,69568,69568,0.36119,46946,22622,2.075236495
2008,LP6005441-DNA_H12,1,72745,191746,191746,0.37938,132217,59529,2.221051924
2009,LP6005441-DNA_H12,10,58424,110682,110682,0.52785,76158,34524,2.205943691
2010,LP6005441-DNA_H12,11,48203,121648,121648,0.39625,82722,38926,2.125109182
2011,LP6005441-DNA_H12,12,44745,117299,117299,0.38146,80487,36812,2.186433772
2012,LP6005441-DNA_H12,13,42257,98224,98224,0.43021,66986,31238,2.14437544
2013,LP6005441-DNA_H12,14,32315,78151,78151,0.41349,53470,24681,2.166443823
2014,LP6005441-DNA_H12,15,28584,71251,71251,0.40117,48535,22716,2.136599753
2015,LP6005441-DNA_H12,16,27124,71040,71040,0.38181,46410,24630,1.884287454
2016,LP6005441-DNA_H12,17,22239,59142,59142,0.37603,41664,17478,2.383796773
2017,LP6005441-DNA_H12,18,30553,73364,73364,0.41646,50349,23015,2.187660222
2018,LP6005441-DNA_H12,19,16162,39917,39917,0.40489,28016,11901,2.354087892
2019,LP6005441-DNA_H12,2,84578,203973,203973,0.41465,138494,65479,2.115090334
2020,LP6005441-DNA_H12,20,18645,52575,52575,0.35464,36659,15916,2.303279719
2021,LP6005441-DNA_H12,21,13468,34718,34718,0.38793,23690,11028,2.148168299
2022,LP6005441-DNA_H12,22,9323,26237,26237,0.35534,18499,7738,2.390669424
2023,LP6005441-DNA_H12,3,65566,176191,176191,0.37213,118934,57257,2.077195801
2024,LP6005441-DNA_H12,4,73135,187996,187996,0.38902,126909,61087,2.0775124
2025,LP6005441-DNA_H12,5,58395,158828,158828,0.36766,107123,51705,2.071811237
2026,LP6005441-DNA_H12,6,57723,159778,159778,0.36127,109372,50406,2.169821053
2027,LP6005441-DNA_H12,7,48673,132904,132904,0.36623,90534,42370,2.136747699
2028,LP6005441-DNA_H12,8,53105,128873,128873,0.41207,85293,43580,1.957159247
2029,LP6005441-DNA_H12,9,39207,101341,101341,0.38688,67735,33606,2.015562697
2030,LP6005441-DNA_H12,MT,26,30,30,0.86667,27,3,9
2031,LP6005441-DNA_H12,X,23556,66689,66689,0.35322,45033,21656,2.079469893
2032,LP6005442-DNA_A02,1,78454,236334,236334,0.33196,163205,73129,2.23174117
2033,LP6005442-DNA_A02,10,50700,150767,150767,0.33628,103738,47029,2.205830445
2034,LP6005442-DNA_A02,11,47956,150513,150513,0.31862,102354,48159,2.125334828
2035,LP6005442-DNA_A02,12,47118,140759,140759,0.33474,96834,43925,2.20453045
2036,LP6005442-DNA_A02,13,39002,113687,113687,0.34306,77473,36214,2.139310764
2037,LP6005442-DNA_A02,14,36305,99212,99212,0.36593,67902,31310,2.168700096
2038,LP6005442-DNA_A02,15,29788,86501,86501,0.34437,59056,27445,2.151794498
2039,LP6005442-DNA_A02,16,30796,92648,92648,0.3324,60908,31740,1.918966604
2040,LP6005442-DNA_A02,17,25692,75439,75439,0.34057,53203,22236,2.392651556
2041,LP6005442-DNA_A02,18,31276,90734,90734,0.3447,62147,28587,2.173960192
2042,LP6005442-DNA_A02,19,19112,56252,56252,0.33976,39631,16621,2.384393237
2043,LP6005442-DNA_A02,2,84966,256415,256415,0.33136,174037,82378,2.112663575
2044,LP6005442-DNA_A02,20,22171,68000,68000,0.32604,47304,20696,2.285659065
2045,LP6005442-DNA_A02,21,16287,44063,44063,0.36963,30118,13945,2.159770527
2046,LP6005442-DNA_A02,22,12596,35711,35711,0.35272,25266,10445,2.418956438
2047,LP6005442-DNA_A02,3,76995,228604,228604,0.33681,154475,74129,2.083867312
2048,LP6005442-DNA_A02,4,75914,228874,228874,0.33168,154459,74415,2.075643351
2049,LP6005442-DNA_A02,5,65516,200033,200033,0.32753,135232,64801,2.086881375
2050,LP6005442-DNA_A02,6,65225,200708,200708,0.32497,137494,63214,2.175056158
2051,LP6005442-DNA_A02,7,59708,175537,175537,0.34014,118892,56645,2.098896637
2052,LP6005442-DNA_A02,8,58416,176759,176759,0.33048,117441,59318,1.979854344
2053,LP6005442-DNA_A02,9,42175,128696,128696,0.32771,86226,42470,2.030280198
2054,LP6005442-DNA_A02,MT,35,39,39,0.89744,NA,NA,NA
2055,LP6005442-DNA_A02,X,70577,71942,71942,0.98103,48034,23908,2.009118287
2056,LP6005442-DNA_A02,Y,924,982,982,0.94094,610,372,1.639784946
2057,LP6005442-DNA_A03,1,76592,194761,194761,0.39326,134470,60291,2.230349472
2058,LP6005442-DNA_A03,10,49889,127551,127551,0.39113,87674,39877,2.198610728
2059,LP6005442-DNA_A03,11,52437,128836,128836,0.40701,87588,41248,2.12344841
2060,LP6005442-DNA_A03,12,47485,120371,120371,0.39449,82839,37532,2.20715656
2061,LP6005442-DNA_A03,13,42081,100229,100229,0.41985,68473,31756,2.156222446
2062,LP6005442-DNA_A03,14,31325,84730,84730,0.3697,58063,26667,2.177335283
2063,LP6005442-DNA_A03,15,28244,71946,71946,0.39257,49142,22804,2.154972812
2064,LP6005442-DNA_A03,16,28707,75332,75332,0.38107,49489,25843,1.91498665
2065,LP6005442-DNA_A03,17,21814,64022,64022,0.34073,45312,18710,2.421806521
2066,LP6005442-DNA_A03,18,28653,75809,75809,0.37796,51973,23836,2.180441349
2067,LP6005442-DNA_A03,19,15931,44470,44470,0.35824,31303,13167,2.377382851
2068,LP6005442-DNA_A03,2,83285,212074,212074,0.39272,144187,67887,2.123926525
2069,LP6005442-DNA_A03,20,18834,55399,55399,0.33997,38744,16655,2.326268388
2070,LP6005442-DNA_A03,21,13711,35261,35261,0.38884,24020,11241,2.136820568
2071,LP6005442-DNA_A03,22,9804,29382,29382,0.33367,20867,8515,2.450616559
2072,LP6005442-DNA_A03,3,69360,182642,182642,0.37976,123344,59298,2.080070154
2073,LP6005442-DNA_A03,4,76714,186251,186251,0.41189,126167,60084,2.099843552
2074,LP6005442-DNA_A03,5,56864,160825,160825,0.35358,108707,52118,2.085786101
2075,LP6005442-DNA_A03,6,60533,163022,163022,0.37132,111579,51443,2.168983146
2076,LP6005442-DNA_A03,7,51907,137323,137323,0.37799,93604,43719,2.141037078
2077,LP6005442-DNA_A03,8,50232,138572,138572,0.3625,91820,46752,1.963980151
2078,LP6005442-DNA_A03,9,40040,105757,105757,0.3786,70704,35053,2.017059881
2079,LP6005442-DNA_A03,MT,12,13,13,0.92308,NA,NA,NA
2080,LP6005442-DNA_A03,X,53056,53680,53680,0.98838,35956,17724,2.028661702
2081,LP6005442-DNA_A03,Y,706,732,732,0.96448,446,286,1.559440559
2082,LP6005442-DNA_A04,1,77617,190254,190254,0.40797,131196,59058,2.221477192
2083,LP6005442-DNA_A04,10,53473,126976,126976,0.42113,87407,39569,2.208976724
2084,LP6005442-DNA_A04,11,53903,125291,125291,0.43022,84976,40315,2.107801067
2085,LP6005442-DNA_A04,12,46063,120411,120411,0.38255,82857,37554,2.206342866
2086,LP6005442-DNA_A04,13,42740,103168,103168,0.41428,70594,32574,2.167188555
2087,LP6005442-DNA_A04,14,33553,80734,80734,0.4156,55139,25595,2.154287947
2088,LP6005442-DNA_A04,15,28637,71174,71174,0.40235,48314,22860,2.113473316
2089,LP6005442-DNA_A04,16,27678,70776,70776,0.39106,46408,24368,1.904464872
2090,LP6005442-DNA_A04,17,23983,60584,60584,0.39586,42762,17822,2.399394007
2091,LP6005442-DNA_A04,18,29907,76326,76326,0.39183,52356,23970,2.184230288
2092,LP6005442-DNA_A04,19,15236,42130,42130,0.36164,29650,12480,2.375801282
2093,LP6005442-DNA_A04,2,85637,217757,217757,0.39327,148001,69756,2.121695625
2094,LP6005442-DNA_A04,20,18683,52751,52751,0.35417,36800,15951,2.307065388
2095,LP6005442-DNA_A04,21,14757,36938,36938,0.39951,25182,11756,2.142055121
2096,LP6005442-DNA_A04,22,8912,28793,28793,0.30952,20406,8387,2.433051151
2097,LP6005442-DNA_A04,3,70471,181731,181731,0.38778,122879,58852,2.087932441
2098,LP6005442-DNA_A04,4,77023,194669,194669,0.39566,131576,63093,2.085429445
2099,LP6005442-DNA_A04,5,59661,159458,159458,0.37415,107925,51533,2.094289096
2100,LP6005442-DNA_A04,6,59693,165069,165069,0.36162,112946,52123,2.166912879
2101,LP6005442-DNA_A04,7,52660,141058,141058,0.37332,96147,44911,2.140834094
2102,LP6005442-DNA_A04,8,54630,143039,143039,0.38192,94872,48167,1.969647269
2103,LP6005442-DNA_A04,9,39375,106108,106108,0.37108,70922,35186,2.015631217
2104,LP6005442-DNA_A04,MT,32,33,33,0.9697,NA,NA,NA
2105,LP6005442-DNA_A04,X,50683,51472,51472,0.98467,34563,16909,2.044059377
2106,LP6005442-DNA_A04,Y,705,731,731,0.96443,432,299,1.444816054
2107,LP6005442-DNA_A08,1,78631,194013,194013,0.40529,134054,59959,2.235761103
2108,LP6005442-DNA_A08,10,47960,128496,128496,0.37324,88490,40006,2.211918212
2109,LP6005442-DNA_A08,11,51259,128056,128056,0.40029,87113,40943,2.127665291
2110,LP6005442-DNA_A08,12,48002,118640,118640,0.4046,81610,37030,2.203888739
2111,LP6005442-DNA_A08,13,41317,102658,102658,0.40247,69898,32760,2.133638584
2112,LP6005442-DNA_A08,14,30382,81659,81659,0.37206,56016,25643,2.184455797
2113,LP6005442-DNA_A08,15,30356,72582,72582,0.41823,49383,23199,2.128669339
2114,LP6005442-DNA_A08,16,27706,73798,73798,0.37543,48488,25310,1.91576452
2115,LP6005442-DNA_A08,17,22607,61012,61012,0.37053,43326,17686,2.449734253
2116,LP6005442-DNA_A08,18,29396,75314,75314,0.39031,51688,23626,2.187759248
2117,LP6005442-DNA_A08,19,15641,45189,45189,0.34612,31801,13388,2.375336122
2118,LP6005442-DNA_A08,2,84143,211924,211924,0.39704,144145,67779,2.126691158
2119,LP6005442-DNA_A08,20,18669,53732,53732,0.34745,37574,16158,2.325411561
2120,LP6005442-DNA_A08,21,13587,35499,35499,0.38274,24376,11123,2.1914951
2121,LP6005442-DNA_A08,22,10357,29399,29399,0.35229,20852,8547,2.43968644
2122,LP6005442-DNA_A08,3,69158,181425,181425,0.38119,122889,58536,2.099374744
2123,LP6005442-DNA_A08,4,76624,185145,185145,0.41386,125202,59943,2.08868425
2124,LP6005442-DNA_A08,5,57558,156583,156583,0.36759,106120,50463,2.102926897
2125,LP6005442-DNA_A08,6,59445,161957,161957,0.36704,111092,50865,2.184055834
2126,LP6005442-DNA_A08,7,49395,138786,138786,0.35591,94657,44129,2.145006685
2127,LP6005442-DNA_A08,8,53239,136464,136464,0.39013,90518,45946,1.970095329
2128,LP6005442-DNA_A08,9,40928,103990,103990,0.39358,69593,34397,2.02322877
2129,LP6005442-DNA_A08,MT,10,13,13,0.76923,11,2,5.5
2130,LP6005442-DNA_A08,X,49948,50670,50670,0.98575,34067,16603,2.051858098
2131,LP6005442-DNA_A08,Y,680,704,704,0.96591,453,251,1.804780876
2132,LP6005442-DNA_A10,1,78828,235154,235154,0.33522,162248,72906,2.225440979
2133,LP6005442-DNA_A10,10,52955,151332,151332,0.34993,104156,47176,2.207817534
2134,LP6005442-DNA_A10,11,51581,151307,151307,0.3409,102891,48416,2.12514458
2135,LP6005442-DNA_A10,12,49015,138916,138916,0.35284,95599,43317,2.206962624
2136,LP6005442-DNA_A10,13,37147,116428,116428,0.31906,79409,37019,2.145087658
2137,LP6005442-DNA_A10,14,33959,99841,99841,0.34013,68351,31490,2.170562083
2138,LP6005442-DNA_A10,15,30893,91035,91035,0.33935,61821,29214,2.116142945
2139,LP6005442-DNA_A10,16,31553,94508,94508,0.33387,62208,32300,1.925944272
2140,LP6005442-DNA_A10,17,26186,76092,76092,0.34414,53669,22423,2.393479909
2141,LP6005442-DNA_A10,18,29555,90928,90928,0.32504,62250,28678,2.170653463
2142,LP6005442-DNA_A10,19,20260,57665,57665,0.35134,40638,17027,2.386679979
2143,LP6005442-DNA_A10,2,92317,259633,259633,0.35557,176497,83136,2.122991243
2144,LP6005442-DNA_A10,20,21484,68801,68801,0.31226,48088,20713,2.321633757
2145,LP6005442-DNA_A10,21,16010,44326,44326,0.36119,30340,13986,2.169312169
2146,LP6005442-DNA_A10,22,13217,36773,36773,0.35942,26084,10689,2.440265694
2147,LP6005442-DNA_A10,3,76118,228542,228542,0.33306,154810,73732,2.099631096
2148,LP6005442-DNA_A10,4,78766,231857,231857,0.33972,156447,75410,2.074618751
2149,LP6005442-DNA_A10,5,69007,205152,205152,0.33637,138876,66276,2.095419156
2150,LP6005442-DNA_A10,6,67543,203276,203276,0.33227,139255,64021,2.175145655
2151,LP6005442-DNA_A10,7,59960,176734,176734,0.33927,119940,56794,2.1118428
2152,LP6005442-DNA_A10,8,61432,175880,175880,0.34928,116620,59260,1.967937901
2153,LP6005442-DNA_A10,9,44231,130862,130862,0.338,87297,43565,2.003833352
2154,LP6005442-DNA_A10,MT,36,40,40,0.9,39,1,39
2155,LP6005442-DNA_A10,X,74204,75610,75610,0.9814,50767,24843,2.043513263
2156,LP6005442-DNA_A10,Y,944,995,995,0.94874,618,377,1.639257294
2157,LP6005442-DNA_A11,1,77279,199865,199865,0.38666,137825,62040,2.221550613
2158,LP6005442-DNA_A11,10,49501,124150,124150,0.39872,85640,38510,2.223837964
2159,LP6005442-DNA_A11,11,52207,127913,127913,0.40814,87045,40868,2.129906039
2160,LP6005442-DNA_A11,12,46914,124321,124321,0.37736,85227,39094,2.180053205
2161,LP6005442-DNA_A11,13,43230,103415,103415,0.41802,70625,32790,2.153857884
2162,LP6005442-DNA_A11,14,33825,83909,83909,0.40312,57451,26458,2.171403734
2163,LP6005442-DNA_A11,15,32031,73376,73376,0.43653,49929,23447,2.129440867
2164,LP6005442-DNA_A11,16,29329,73558,73558,0.39872,48342,25216,1.917116117
2165,LP6005442-DNA_A11,17,22761,63518,63518,0.35834,44916,18602,2.414579078
2166,LP6005442-DNA_A11,18,31549,76612,76612,0.4118,52707,23905,2.204852541
2167,LP6005442-DNA_A11,19,15801,43976,43976,0.35931,30857,13119,2.352084763
2168,LP6005442-DNA_A11,2,81265,211359,211359,0.38449,143676,67683,2.122778246
2169,LP6005442-DNA_A11,20,19222,51858,51858,0.37067,36179,15679,2.307481344
2170,LP6005442-DNA_A11,21,13952,35309,35309,0.39514,24171,11138,2.170138265
2171,LP6005442-DNA_A11,22,9605,28961,28961,0.33165,20590,8371,2.459682236
2172,LP6005442-DNA_A11,3,69948,183881,183881,0.3804,124259,59622,2.084113247
2173,LP6005442-DNA_A11,4,81936,190149,190149,0.4309,128563,61586,2.087536128
2174,LP6005442-DNA_A11,5,60975,166468,166468,0.36629,112549,53919,2.087371798
2175,LP6005442-DNA_A11,6,61407,163131,163131,0.37643,111808,51323,2.178516455
2176,LP6005442-DNA_A11,7,52350,143153,143153,0.36569,97558,45595,2.139664437
2177,LP6005442-DNA_A11,8,54583,142054,142054,0.38424,94083,47971,1.96124742
2178,LP6005442-DNA_A11,9,39803,111904,111904,0.35569,74831,37073,2.018477059
2179,LP6005442-DNA_A11,MT,14,15,15,0.93333,13,2,6.5
2180,LP6005442-DNA_A11,X,50598,51559,51559,0.98136,34727,16832,2.063153517
2181,LP6005442-DNA_A11,Y,146,173,173,0.84393,88,85,1.035294118
2182,LP6005442-DNA_A12,1,78530,198905,198905,0.39481,136910,61995,2.208403904
2183,LP6005442-DNA_A12,10,50998,132794,132794,0.38404,91167,41627,2.190092969
2184,LP6005442-DNA_A12,11,52639,129815,129815,0.40549,88023,41792,2.106216501
2185,LP6005442-DNA_A12,12,50258,124212,124212,0.40461,85465,38747,2.205719152
2186,LP6005442-DNA_A12,13,43563,107643,107643,0.4047,73198,34445,2.125068951
2187,LP6005442-DNA_A12,14,33062,86233,86233,0.3834,58599,27634,2.120539915
2188,LP6005442-DNA_A12,15,28703,74784,74784,0.38381,50830,23954,2.121983802
2189,LP6005442-DNA_A12,16,28707,75233,75233,0.38157,49485,25748,1.921896846
2190,LP6005442-DNA_A12,17,21070,56262,56262,0.3745,39635,16627,2.383773381
2191,LP6005442-DNA_A12,18,32818,82592,82592,0.39735,56448,26144,2.159118727
2192,LP6005442-DNA_A12,19,13172,38905,38905,0.33857,27296,11609,2.35127918
2193,LP6005442-DNA_A12,2,88981,224020,224020,0.3972,152381,71639,2.127067659
2194,LP6005442-DNA_A12,20,19525,53816,53816,0.36281,37526,16290,2.303621854
2195,LP6005442-DNA_A12,21,15172,36836,36836,0.41188,25146,11690,2.15106929
2196,LP6005442-DNA_A12,22,9828,27022,27022,0.3637,19179,7843,2.445365294
2197,LP6005442-DNA_A12,3,75505,189096,189096,0.39929,127703,61393,2.080090564
2198,LP6005442-DNA_A12,4,88095,201267,201267,0.4377,135928,65339,2.080350174
2199,LP6005442-DNA_A12,5,61987,170755,170755,0.36302,115259,55496,2.076888424
2200,LP6005442-DNA_A12,6,61967,167116,167116,0.3708,114274,52842,2.162560085
2201,LP6005442-DNA_A12,7,56851,145090,145090,0.39183,98526,46564,2.115926467
2202,LP6005442-DNA_A12,8,54334,148967,148967,0.36474,98495,50472,1.951478047
2203,LP6005442-DNA_A12,9,43805,110433,110433,0.39667,73629,36804,2.00057059
2204,LP6005442-DNA_A12,MT,39,40,40,0.975,NA,NA,NA
2205,LP6005442-DNA_A12,X,52388,53155,53155,0.98557,35777,17378,2.058752446
2206,LP6005442-DNA_A12,Y,458,488,488,0.93852,310,178,1.741573034
2207,LP6005442-DNA_B01,1,74055,189700,189700,0.39038,131033,58667,2.233504355
2208,LP6005442-DNA_B01,10,49342,124295,124295,0.39697,85568,38727,2.209517907
2209,LP6005442-DNA_B01,11,49256,122358,122358,0.40256,83121,39237,2.118434131
2210,LP6005442-DNA_B01,12,42989,116227,116227,0.36987,79788,36439,2.189631988
2211,LP6005442-DNA_B01,13,40135,97471,97471,0.41176,66451,31020,2.142198582
2212,LP6005442-DNA_B01,14,31335,81938,81938,0.38242,56015,25923,2.160822436
2213,LP6005442-DNA_B01,15,27962,71587,71587,0.3906,48653,22934,2.121435423
2214,LP6005442-DNA_B01,16,27795,71931,71931,0.38641,47237,24694,1.91289382
2215,LP6005442-DNA_B01,17,22337,58330,58330,0.38294,41020,17310,2.369728481
2216,LP6005442-DNA_B01,18,28726,73231,73231,0.39227,50360,22871,2.201915089
2217,LP6005442-DNA_B01,19,13783,42464,42464,0.32458,29944,12520,2.391693291
2218,LP6005442-DNA_B01,2,81259,209223,209223,0.38838,142218,67005,2.122498321
2219,LP6005442-DNA_B01,20,18575,51739,51739,0.35901,36074,15665,2.302840728
2220,LP6005442-DNA_B01,21,12494,34823,34823,0.35879,23847,10976,2.172649417
2221,LP6005442-DNA_B01,22,10314,29526,29526,0.34932,20872,8654,2.411832679
2222,LP6005442-DNA_B01,3,64445,178148,178148,0.36175,120584,57564,2.094781461
2223,LP6005442-DNA_B01,4,71229,181796,181796,0.39181,123154,58642,2.100098905
2224,LP6005442-DNA_B01,5,54944,155319,155319,0.35375,104952,50367,2.083745309
2225,LP6005442-DNA_B01,6,58341,160235,160235,0.3641,109862,50373,2.180969964
2226,LP6005442-DNA_B01,7,48312,134579,134579,0.35899,91751,42828,2.14231344
2227,LP6005442-DNA_B01,8,48427,134253,134253,0.36071,89351,44902,1.989911363
2228,LP6005442-DNA_B01,9,39718,104531,104531,0.37996,69910,34621,2.019294648
2229,LP6005442-DNA_B01,MT,32,36,36,0.88889,31,5,6.2
2230,LP6005442-DNA_B01,X,25548,69637,69637,0.36687,47003,22634,2.07665459
2231,LP6005442-DNA_B02,1,79756,236818,236818,0.33678,163533,73285,2.231466194
2232,LP6005442-DNA_B02,10,49454,149904,149904,0.3299,103247,46657,2.212894099
2233,LP6005442-DNA_B02,11,49782,150383,150383,0.33103,102690,47693,2.153146164
2234,LP6005442-DNA_B02,12,46004,143358,143358,0.3209,98736,44622,2.212720183
2235,LP6005442-DNA_B02,13,38249,110181,110181,0.34715,75342,34839,2.162576423
2236,LP6005442-DNA_B02,14,34261,100177,100177,0.342,68664,31513,2.178910291
2237,LP6005442-DNA_B02,15,29825,89716,89716,0.33244,60994,28722,2.123598635
2238,LP6005442-DNA_B02,16,31452,93856,93856,0.33511,61717,32139,1.920314882
2239,LP6005442-DNA_B02,17,26323,78351,78351,0.33596,55224,23127,2.387858347
2240,LP6005442-DNA_B02,18,29794,88680,88680,0.33597,60992,27688,2.202831552
2241,LP6005442-DNA_B02,19,20274,59238,59238,0.34225,41534,17704,2.346023498
2242,LP6005442-DNA_B02,2,85784,261395,261395,0.32818,177907,83488,2.130928996
2243,LP6005442-DNA_B02,20,22412,69392,69392,0.32298,48470,20922,2.316700124
2244,LP6005442-DNA_B02,21,14950,45902,45902,0.32569,31589,14313,2.207014602
2245,LP6005442-DNA_B02,22,13714,39131,39131,0.35046,27606,11525,2.395314534
2246,LP6005442-DNA_B02,3,76840,226755,226755,0.33887,153602,73153,2.099736169
2247,LP6005442-DNA_B02,4,74211,219225,219225,0.33852,147997,71228,2.077792441
2248,LP6005442-DNA_B02,5,65176,196644,196644,0.33144,132862,63782,2.083064187
2249,LP6005442-DNA_B02,6,66188,199519,199519,0.33174,136706,62813,2.176396606
2250,LP6005442-DNA_B02,7,59347,174201,174201,0.34068,118239,55962,2.11284443
2251,LP6005442-DNA_B02,8,57959,175669,175669,0.32993,116763,58906,1.982191967
2252,LP6005442-DNA_B02,9,42053,129319,129319,0.32519,86765,42554,2.03893876
2253,LP6005442-DNA_B02,MT,52,55,55,0.94545,53,2,26.5
2254,LP6005442-DNA_B02,X,34323,104252,104252,0.32923,70417,33835,2.081188119
2255,LP6005442-DNA_B03,1,74080,195624,195624,0.37869,134864,60760,2.21961817
2256,LP6005442-DNA_B03,10,49801,128198,128198,0.38847,88230,39968,2.207516013
2257,LP6005442-DNA_B03,11,51349,125238,125238,0.41001,85146,40092,2.12376534
2258,LP6005442-DNA_B03,12,44675,116851,116851,0.38232,80255,36596,2.192999235
2259,LP6005442-DNA_B03,13,41775,99848,99848,0.41839,67998,31850,2.134945055
2260,LP6005442-DNA_B03,14,31248,81816,81816,0.38193,56072,25744,2.178060907
2261,LP6005442-DNA_B03,15,28819,72658,72658,0.39664,49436,23222,2.128843338
2262,LP6005442-DNA_B03,16,27655,75008,75008,0.36869,49409,25599,1.930114458
2263,LP6005442-DNA_B03,17,22456,61952,61952,0.36247,43919,18033,2.435479399
2264,LP6005442-DNA_B03,18,31904,76109,76109,0.41919,52313,23796,2.198394688
2265,LP6005442-DNA_B03,19,14994,44160,44160,0.33954,31193,12967,2.40556798
2266,LP6005442-DNA_B03,2,82052,210928,210928,0.389,143663,67265,2.135776407
2267,LP6005442-DNA_B03,20,19391,54574,54574,0.35532,37916,16658,2.276143595
2268,LP6005442-DNA_B03,21,13782,34874,34874,0.39519,23987,10887,2.203269955
2269,LP6005442-DNA_B03,22,10507,30559,30559,0.34383,21628,8931,2.421677304
2270,LP6005442-DNA_B03,3,70932,178976,178976,0.39632,121010,57966,2.087603078
2271,LP6005442-DNA_B03,4,74579,191540,191540,0.38937,129322,62218,2.078530329
2272,LP6005442-DNA_B03,5,55361,160590,160590,0.34474,108624,51966,2.090289805
2273,LP6005442-DNA_B03,6,59551,157902,157902,0.37714,108282,49620,2.182224909
2274,LP6005442-DNA_B03,7,51943,139807,139807,0.37153,95447,44360,2.151645627
2275,LP6005442-DNA_B03,8,55214,138548,138548,0.39852,91979,46569,1.975112199
2276,LP6005442-DNA_B03,9,38646,106114,106114,0.36419,71081,35033,2.028972683
2277,LP6005442-DNA_B03,MT,12,13,13,0.92308,NA,NA,NA
2278,LP6005442-DNA_B03,X,50492,51236,51236,0.98548,34555,16681,2.071518494
2279,LP6005442-DNA_B03,Y,1008,1022,1022,0.9863,647,375,1.725333333
2280,LP6005442-DNA_B04,1,75057,195246,195246,0.38442,134974,60272,2.239414654
2281,LP6005442-DNA_B04,10,50831,126901,126901,0.40056,87200,39701,2.196418226
2282,LP6005442-DNA_B04,11,51166,131887,131887,0.38795,89717,42170,2.127507707
2283,LP6005442-DNA_B04,12,45251,120439,120439,0.37572,82848,37591,2.203931792
2284,LP6005442-DNA_B04,13,45670,101589,101589,0.44956,69318,32271,2.147996653
2285,LP6005442-DNA_B04,14,32986,83972,83972,0.39282,57567,26405,2.180155274
2286,LP6005442-DNA_B04,15,30415,73626,73626,0.4131,50272,23354,2.15260769
2287,LP6005442-DNA_B04,16,28632,76070,76070,0.37639,49799,26271,1.895588291
2288,LP6005442-DNA_B04,17,23700,60786,60786,0.38989,42904,17882,2.399284196
2289,LP6005442-DNA_B04,18,32444,77880,77880,0.41659,53539,24341,2.199539871
2290,LP6005442-DNA_B04,19,15693,43866,43866,0.35775,30937,12929,2.392837806
2291,LP6005442-DNA_B04,2,85681,218818,218818,0.39156,148866,69952,2.128116423
2292,LP6005442-DNA_B04,20,18475,53505,53505,0.34529,37372,16133,2.316494142
2293,LP6005442-DNA_B04,21,14505,36730,36730,0.39491,25142,11588,2.169658267
2294,LP6005442-DNA_B04,22,9110,27613,27613,0.32992,19610,8003,2.450331126
2295,LP6005442-DNA_B04,3,70668,183278,183278,0.38558,124140,59138,2.099157902
2296,LP6005442-DNA_B04,4,78520,190051,190051,0.41315,128782,61269,2.101911244
2297,LP6005442-DNA_B04,5,59612,161990,161990,0.368,109720,52270,2.099100823
2298,LP6005442-DNA_B04,6,61181,164885,164885,0.37105,113194,51691,2.189820278
2299,LP6005442-DNA_B04,7,51938,142271,142271,0.36506,97024,45247,2.14431896
2300,LP6005442-DNA_B04,8,52829,143580,143580,0.36794,95245,48335,1.970518258
2301,LP6005442-DNA_B04,9,38832,106191,106191,0.36568,71019,35172,2.019191402
2302,LP6005442-DNA_B04,MT,32,34,34,0.94118,33,1,33
2303,LP6005442-DNA_B04,X,48600,49177,49177,0.98827,33185,15992,2.07510005
2304,LP6005442-DNA_B04,Y,708,723,723,0.97925,456,267,1.707865169
2305,LP6005442-DNA_B08,1,79626,199488,199488,0.39915,137848,61640,2.236340039
2306,LP6005442-DNA_B08,10,52815,130319,130319,0.40527,89914,40405,2.225318649
2307,LP6005442-DNA_B08,11,52715,129667,129667,0.40654,88111,41556,2.120295505
2308,LP6005442-DNA_B08,12,46391,122941,122941,0.37734,84640,38301,2.209863972
2309,LP6005442-DNA_B08,13,45444,102272,102272,0.44434,69801,32471,2.149641218
2310,LP6005442-DNA_B08,14,32835,84714,84714,0.3876,58010,26704,2.172333733
2311,LP6005442-DNA_B08,15,29690,76343,76343,0.3889,52103,24240,2.149463696
2312,LP6005442-DNA_B08,16,28243,78657,78657,0.35907,51620,27037,1.909235492
2313,LP6005442-DNA_B08,17,23889,62244,62244,0.3838,44000,18244,2.411751809
2314,LP6005442-DNA_B08,18,31058,78979,78979,0.39324,54172,24807,2.183738461
2315,LP6005442-DNA_B08,19,14982,45724,45724,0.32766,32270,13454,2.398543184
2316,LP6005442-DNA_B08,2,86670,218740,218740,0.39622,149008,69732,2.136866862
2317,LP6005442-DNA_B08,20,20439,55902,55902,0.36562,39041,16861,2.315461716
2318,LP6005442-DNA_B08,21,14765,37323,37323,0.3956,25538,11785,2.166991939
2319,LP6005442-DNA_B08,22,10355,30286,30286,0.34191,21496,8790,2.445506257
2320,LP6005442-DNA_B08,3,70476,185324,185324,0.38029,125254,60070,2.08513401
2321,LP6005442-DNA_B08,4,80243,194841,194841,0.41184,131854,62987,2.093352597
2322,LP6005442-DNA_B08,5,60508,159754,159754,0.37876,107955,51799,2.084113593
2323,LP6005442-DNA_B08,6,60648,167759,167759,0.36152,115028,52731,2.181411314
2324,LP6005442-DNA_B08,7,52368,144545,144545,0.3623,98436,46109,2.134854367
2325,LP6005442-DNA_B08,8,55264,138565,138565,0.39883,92146,46419,1.985092311
2326,LP6005442-DNA_B08,9,41040,108755,108755,0.37736,72725,36030,2.018456842
2327,LP6005442-DNA_B08,MT,32,36,36,0.88889,34,2,17
2328,LP6005442-DNA_B08,X,29768,71584,71584,0.41585,48469,23115,2.096863509
2329,LP6005442-DNA_B10,1,77672,234557,234557,0.33114,161727,72830,2.220609639
2330,LP6005442-DNA_B10,10,49114,148669,148669,0.33036,102078,46591,2.190938164
2331,LP6005442-DNA_B10,11,48320,146092,146092,0.33075,99448,46644,2.132064145
2332,LP6005442-DNA_B10,12,45136,140893,140893,0.32036,96815,44078,2.196447207
2333,LP6005442-DNA_B10,13,37672,109728,109728,0.34332,74801,34927,2.141638274
2334,LP6005442-DNA_B10,14,33353,95933,95933,0.34767,65866,30067,2.190640902
2335,LP6005442-DNA_B10,15,29939,89319,89319,0.33519,60671,28648,2.117809271
2336,LP6005442-DNA_B10,16,32264,93321,93321,0.34573,61355,31966,1.919383095
2337,LP6005442-DNA_B10,17,24785,77201,77201,0.32105,54386,22815,2.383782599
2338,LP6005442-DNA_B10,18,30235,89326,89326,0.33848,61336,27990,2.191354055
2339,LP6005442-DNA_B10,19,19291,57686,57686,0.33441,40532,17154,2.362830827
2340,LP6005442-DNA_B10,2,87338,257740,257740,0.33886,175111,82629,2.119243849
2341,LP6005442-DNA_B10,20,22794,67996,67996,0.33523,47537,20459,2.323525099
2342,LP6005442-DNA_B10,21,16139,44427,44427,0.36327,30324,14103,2.150180813
2343,LP6005442-DNA_B10,22,12820,37780,37780,0.33933,26716,11064,2.414678236
2344,LP6005442-DNA_B10,3,77141,224835,224835,0.3431,152020,72815,2.087756644
2345,LP6005442-DNA_B10,4,75022,224936,224936,0.33353,151713,73223,2.071930951
2346,LP6005442-DNA_B10,5,69705,197502,197502,0.35293,133470,64032,2.084426537
2347,LP6005442-DNA_B10,6,64617,194396,194396,0.3324,133394,61002,2.18671519
2348,LP6005442-DNA_B10,7,58782,171646,171646,0.34246,116399,55247,2.106883632
2349,LP6005442-DNA_B10,8,58416,173647,173647,0.33641,115373,58274,1.979836634
2350,LP6005442-DNA_B10,9,43368,128653,128653,0.33709,86356,42297,2.041657801
2351,LP6005442-DNA_B10,MT,38,42,42,0.90476,40,2,20
2352,LP6005442-DNA_B10,X,37195,104061,104061,0.35743,70261,33800,2.078727811
2353,LP6005442-DNA_B11,1,79364,198523,198523,0.39977,137382,61141,2.246970118
2354,LP6005442-DNA_B11,10,48019,129243,129243,0.37154,89216,40027,2.228895496
2355,LP6005442-DNA_B11,11,52156,129650,129650,0.40228,88165,41485,2.125225985
2356,LP6005442-DNA_B11,12,47924,121701,121701,0.39378,83780,37921,2.209329923
2357,LP6005442-DNA_B11,13,43803,101409,101409,0.43194,69006,32403,2.129617628
2358,LP6005442-DNA_B11,14,31103,84238,84238,0.36923,57573,26665,2.159122445
2359,LP6005442-DNA_B11,15,29682,74441,74441,0.39873,50842,23599,2.154413323
2360,LP6005442-DNA_B11,16,28775,75275,75275,0.38227,49281,25994,1.895860583
2361,LP6005442-DNA_B11,17,22763,64440,64440,0.35324,45521,18919,2.406099688
2362,LP6005442-DNA_B11,18,29206,76900,76900,0.37979,52722,24178,2.180577384
2363,LP6005442-DNA_B11,19,15760,46057,46057,0.34218,32350,13707,2.360107974
2364,LP6005442-DNA_B11,2,85346,212219,212219,0.40216,144322,67897,2.125602015
2365,LP6005442-DNA_B11,20,18540,51739,51739,0.35834,36170,15569,2.323206372
2366,LP6005442-DNA_B11,21,13373,35965,35965,0.37183,24617,11348,2.169280931
2367,LP6005442-DNA_B11,22,10841,28230,28230,0.38402,19999,8231,2.429716924
2368,LP6005442-DNA_B11,3,70041,182644,182644,0.38348,123722,58922,2.099759003
2369,LP6005442-DNA_B11,4,78524,189428,189428,0.41453,128152,61276,2.091389777
2370,LP6005442-DNA_B11,5,57863,157366,157366,0.3677,106397,50969,2.087484549
2371,LP6005442-DNA_B11,6,62458,159803,159803,0.39084,109441,50362,2.173086851
2372,LP6005442-DNA_B11,7,51176,140978,140978,0.36301,96066,44912,2.1389829
2373,LP6005442-DNA_B11,8,52142,138438,138438,0.37665,91662,46776,1.959594664
2374,LP6005442-DNA_B11,9,39674,105820,105820,0.37492,70684,35136,2.011725865
2375,LP6005442-DNA_B11,MT,10,12,12,0.83333,11,1,11
2376,LP6005442-DNA_B11,X,27938,73701,73701,0.37907,49814,23887,2.085402102
2377,LP6005442-DNA_B12,1,77112,194799,194799,0.39585,134109,60690,2.209738013
2378,LP6005442-DNA_B12,10,54290,130479,130479,0.41608,89856,40623,2.211948896
2379,LP6005442-DNA_B12,11,52275,127922,127922,0.40865,86626,41296,2.097685006
2380,LP6005442-DNA_B12,12,47466,120358,120358,0.39437,82815,37543,2.205870602
2381,LP6005442-DNA_B12,13,45444,107191,107191,0.42395,72992,34199,2.134331413
2382,LP6005442-DNA_B12,14,31500,81691,81691,0.3856,55652,26039,2.137255655
2383,LP6005442-DNA_B12,15,30010,71795,71795,0.418,48838,22957,2.127368559
2384,LP6005442-DNA_B12,16,28973,73902,73902,0.39205,48413,25489,1.899368355
2385,LP6005442-DNA_B12,17,20251,54432,54432,0.37204,38341,16091,2.382760549
2386,LP6005442-DNA_B12,18,33168,78258,78258,0.42383,53662,24596,2.181736868
2387,LP6005442-DNA_B12,19,13186,36606,36606,0.36021,25752,10854,2.372581537
2388,LP6005442-DNA_B12,2,85226,220046,220046,0.38731,149406,70640,2.115033975
2389,LP6005442-DNA_B12,20,19621,51440,51440,0.38143,35745,15695,2.277476903
2390,LP6005442-DNA_B12,21,14691,36596,36596,0.40144,24985,11611,2.151838774
2391,LP6005442-DNA_B12,22,8806,26520,26520,0.33205,18781,7739,2.426799328
2392,LP6005442-DNA_B12,3,71003,188744,188744,0.37619,127627,61117,2.088240588
2393,LP6005442-DNA_B12,4,83647,200326,200326,0.41755,135505,64821,2.090449083
2394,LP6005442-DNA_B12,5,63596,164344,164344,0.38697,110859,53485,2.072711975
2395,LP6005442-DNA_B12,6,64031,163102,163102,0.39258,111617,51485,2.167951831
2396,LP6005442-DNA_B12,7,51985,144139,144139,0.36066,97901,46238,2.117327739
2397,LP6005442-DNA_B12,8,52512,146701,146701,0.35795,97152,49549,1.960725746
2398,LP6005442-DNA_B12,9,43716,108863,108863,0.40157,72510,36353,1.994608423
2399,LP6005442-DNA_B12,MT,23,24,24,0.95833,NA,NA,NA
2400,LP6005442-DNA_B12,X,30960,77732,77732,0.39829,52486,25246,2.078982809
2401,LP6005442-DNA_C02,1,76208,190681,190681,0.39966,131395,59286,2.216290524
2402,LP6005442-DNA_C02,10,48634,128147,128147,0.37952,88301,39846,2.216056819
2403,LP6005442-DNA_C02,11,50024,126312,126312,0.39604,85702,40610,2.110366905
2404,LP6005442-DNA_C02,12,48382,121244,121244,0.39905,83444,37800,2.207513228
2405,LP6005442-DNA_C02,13,45088,103857,103857,0.43414,70770,33087,2.138906519
2406,LP6005442-DNA_C02,14,31169,82409,82409,0.37822,56345,26064,2.161794045
2407,LP6005442-DNA_C02,15,28939,74062,74062,0.39074,50354,23708,2.123924414
2408,LP6005442-DNA_C02,16,28876,72751,72751,0.39692,47548,25203,1.886600801
2409,LP6005442-DNA_C02,17,23419,58026,58026,0.40359,40906,17120,2.389369159
2410,LP6005442-DNA_C02,18,30374,75677,75677,0.40136,51813,23864,2.171178344
2411,LP6005442-DNA_C02,19,14492,42234,42234,0.34314,29772,12462,2.389022629
2412,LP6005442-DNA_C02,2,83667,212168,212168,0.39434,144075,68093,2.115856255
2413,LP6005442-DNA_C02,20,18296,52090,52090,0.35124,36342,15748,2.307721615
2414,LP6005442-DNA_C02,21,13989,35496,35496,0.3941,24096,11400,2.113684211
2415,LP6005442-DNA_C02,22,9653,27566,27566,0.35018,19520,8046,2.426050211
2416,LP6005442-DNA_C02,3,69494,182225,182225,0.38136,123057,59168,2.079789751
2417,LP6005442-DNA_C02,4,78212,193690,193690,0.4038,130910,62780,2.085218222
2418,LP6005442-DNA_C02,5,58784,161975,161975,0.36292,109446,52529,2.083534809
2419,LP6005442-DNA_C02,6,59299,158962,158962,0.37304,108931,50031,2.177270093
2420,LP6005442-DNA_C02,7,52212,142411,142411,0.36663,97065,45346,2.140541613
2421,LP6005442-DNA_C02,8,55188,135180,135180,0.40826,89323,45857,1.947859651
2422,LP6005442-DNA_C02,9,38514,104643,104643,0.36805,69932,34711,2.014692749
2423,LP6005442-DNA_C02,MT,35,37,37,0.94595,36,1,36
2424,LP6005442-DNA_C02,X,51528,52177,52177,0.98756,35096,17081,2.054680639
2425,LP6005442-DNA_C02,Y,693,721,721,0.96117,460,261,1.762452107
2426,LP6005442-DNA_C04,1,77346,194336,194336,0.398,134035,60301,2.222765792
2427,LP6005442-DNA_C04,10,50964,134726,134726,0.37828,92834,41892,2.216031701
2428,LP6005442-DNA_C04,11,50835,131648,131648,0.38614,89553,42095,2.127402304
2429,LP6005442-DNA_C04,12,48943,124554,124554,0.39295,85665,38889,2.202807992
2430,LP6005442-DNA_C04,13,44176,104982,104982,0.4208,71650,33332,2.149585983
2431,LP6005442-DNA_C04,14,32126,82685,82685,0.38853,56390,26295,2.144514166
2432,LP6005442-DNA_C04,15,28689,77350,77350,0.3709,52686,24664,2.136149854
2433,LP6005442-DNA_C04,16,30565,75229,75229,0.40629,49338,25891,1.905604264
2434,LP6005442-DNA_C04,17,20808,64334,64334,0.32344,45520,18814,2.419474859
2435,LP6005442-DNA_C04,18,31921,79244,79244,0.40282,54310,24934,2.178150317
2436,LP6005442-DNA_C04,19,15026,42391,42391,0.35446,29825,12566,2.373468088
2437,LP6005442-DNA_C04,2,86528,222827,222827,0.38832,151471,71356,2.122750715
2438,LP6005442-DNA_C04,20,19314,55199,55199,0.3499,38418,16781,2.289374888
2439,LP6005442-DNA_C04,21,14364,37296,37296,0.38514,25612,11684,2.192057515
2440,LP6005442-DNA_C04,22,9699,28747,28747,0.33739,20434,8313,2.45807771
2441,LP6005442-DNA_C04,3,72149,189630,189630,0.38047,128153,61477,2.084568213
2442,LP6005442-DNA_C04,4,79747,201659,201659,0.39545,136314,65345,2.086066264
2443,LP6005442-DNA_C04,5,58967,167499,167499,0.35204,113167,54332,2.082879334
2444,LP6005442-DNA_C04,6,60193,169552,169552,0.35501,115993,53559,2.16570511
2445,LP6005442-DNA_C04,7,53619,146475,146475,0.36606,99743,46732,2.134361893
2446,LP6005442-DNA_C04,8,54454,145571,145571,0.37407,96504,49067,1.966780117
2447,LP6005442-DNA_C04,9,41159,108051,108051,0.38092,72003,36048,1.997420107
2448,LP6005442-DNA_C04,MT,33,33,33,1,32,1,32
2449,LP6005442-DNA_C04,X,51779,52622,52622,0.98398,35282,17340,2.034717416
2450,LP6005442-DNA_C04,Y,512,531,531,0.96422,334,197,1.695431472
2451,LP6005442-DNA_C07,1,89759,189261,189261,0.47426,130506,58755,2.221189686
2452,LP6005442-DNA_C07,10,54793,126608,126608,0.43278,87066,39542,2.201861312
2453,LP6005442-DNA_C07,11,54973,123244,123244,0.44605,83547,39697,2.104617477
2454,LP6005442-DNA_C07,12,54359,118130,118130,0.46016,81231,36899,2.201441773
2455,LP6005442-DNA_C07,13,47748,99492,99492,0.47992,67773,31719,2.136668874
2456,LP6005442-DNA_C07,14,37033,79476,79476,0.46596,54235,25241,2.148686661
2457,LP6005442-DNA_C07,15,31940,71004,71004,0.44983,48354,22650,2.134834437
2458,LP6005442-DNA_C07,16,30248,72619,72619,0.41653,47732,24887,1.91794913
2459,LP6005442-DNA_C07,17,26464,57003,57003,0.46426,40113,16890,2.374955595
2460,LP6005442-DNA_C07,18,33782,74634,74634,0.45264,51092,23542,2.170248917
2461,LP6005442-DNA_C07,19,16196,40644,40644,0.39848,28652,11992,2.389259506
2462,LP6005442-DNA_C07,2,99011,206387,206387,0.47973,139961,66426,2.107021347
2463,LP6005442-DNA_C07,20,23351,52963,52963,0.44089,36961,16002,2.309773778
2464,LP6005442-DNA_C07,21,14865,35553,35553,0.41811,24167,11386,2.122518883
2465,LP6005442-DNA_C07,22,12554,26866,26866,0.46728,19042,7824,2.433793456
2466,LP6005442-DNA_C07,3,83720,184443,184443,0.45391,124351,60092,2.069343673
2467,LP6005442-DNA_C07,4,87217,189854,189854,0.45939,128394,61460,2.089066059
2468,LP6005442-DNA_C07,5,65478,153327,153327,0.42705,103138,50189,2.05499213
2469,LP6005442-DNA_C07,6,71040,164397,164397,0.43212,112272,52125,2.153899281
2470,LP6005442-DNA_C07,7,60846,137460,137460,0.44265,93388,44072,2.118987112
2471,LP6005442-DNA_C07,8,58120,135785,135785,0.42803,89660,46125,1.943848238
2472,LP6005442-DNA_C07,9,45767,106361,106361,0.4303,71088,35273,2.015365861
2473,LP6005442-DNA_C07,MT,38,41,41,0.92683,40,1,40
2474,LP6005442-DNA_C07,X,51329,52397,52397,0.97962,34999,17398,2.011668008
2475,LP6005442-DNA_C07,Y,654,698,698,0.93696,439,259,1.694980695
2476,LP6005442-DNA_C10,1,81771,205767,205767,0.3974,142218,63549,2.237926639
2477,LP6005442-DNA_C10,10,54083,132214,132214,0.40906,91108,41106,2.216416095
2478,LP6005442-DNA_C10,11,55005,132597,132597,0.41483,90050,42547,2.116482948
2479,LP6005442-DNA_C10,12,48416,122871,122871,0.39404,84546,38325,2.206027397
2480,LP6005442-DNA_C10,13,45275,106201,106201,0.42631,72423,33778,2.144087868
2481,LP6005442-DNA_C10,14,35329,85884,85884,0.41136,58578,27306,2.145242804
2482,LP6005442-DNA_C10,15,31325,75570,75570,0.41452,51475,24095,2.136335339
2483,LP6005442-DNA_C10,16,30378,75774,75774,0.4009,49748,26026,1.911473142
2484,LP6005442-DNA_C10,17,24218,63966,63966,0.37861,45345,18621,2.435153859
2485,LP6005442-DNA_C10,18,32681,77869,77869,0.41969,53491,24378,2.194232505
2486,LP6005442-DNA_C10,19,15494,44883,44883,0.34521,31678,13205,2.398939796
2487,LP6005442-DNA_C10,2,90144,223555,223555,0.40323,151954,71601,2.12223293
2488,LP6005442-DNA_C10,20,18964,55828,55828,0.33969,39168,16660,2.351020408
2489,LP6005442-DNA_C10,21,14134,36785,36785,0.38423,25170,11615,2.167025398
2490,LP6005442-DNA_C10,22,10372,30982,30982,0.33478,21940,9042,2.426454324
2491,LP6005442-DNA_C10,3,74788,195155,195155,0.38322,131969,63186,2.088579749
2492,LP6005442-DNA_C10,4,79453,197915,197915,0.40145,134030,63885,2.097988573
2493,LP6005442-DNA_C10,5,62511,168027,168027,0.37203,113486,54541,2.080746594
2494,LP6005442-DNA_C10,6,65140,172678,172678,0.37723,118223,54455,2.171021945
2495,LP6005442-DNA_C10,7,53947,145844,145844,0.3699,99342,46502,2.136295213
2496,LP6005442-DNA_C10,8,55766,145492,145492,0.38329,96434,49058,1.965714053
2497,LP6005442-DNA_C10,9,41894,111435,111435,0.37595,74326,37109,2.002910345
2498,LP6005442-DNA_C10,MT,18,20,20,0.9,NA,NA,NA
2499,LP6005442-DNA_C10,X,3438,5141,5141,0.66874,3477,1664,2.089543269
2500,LP6005442-DNA_C11,1,84799,195917,195917,0.43283,135030,60887,2.217714783
2501,LP6005442-DNA_C11,10,54834,124503,124503,0.44042,85806,38697,2.217381192
2502,LP6005442-DNA_C11,11,52560,125570,125570,0.41857,85236,40334,2.113254326
2503,LP6005442-DNA_C11,12,52422,121760,121760,0.43054,83576,38184,2.188770166
2504,LP6005442-DNA_C11,13,46547,99401,99401,0.46827,67799,31602,2.14540219
2505,LP6005442-DNA_C11,14,34178,81501,81501,0.41936,55595,25906,2.146027947
2506,LP6005442-DNA_C11,15,31578,72653,72653,0.43464,49439,23214,2.129706212
2507,LP6005442-DNA_C11,16,31697,73713,73713,0.43001,48414,25299,1.913672477
2508,LP6005442-DNA_C11,17,25787,60152,60152,0.4287,42395,17757,2.387509151
2509,LP6005442-DNA_C11,18,32731,74890,74890,0.43705,51326,23564,2.178153115
2510,LP6005442-DNA_C11,19,16197,42268,42268,0.3832,29795,12473,2.388759721
2511,LP6005442-DNA_C11,2,93465,209777,209777,0.44554,142298,67479,2.108774582
2512,LP6005442-DNA_C11,20,22331,51870,51870,0.43052,36182,15688,2.306348802
2513,LP6005442-DNA_C11,21,13731,35619,35619,0.3855,24442,11177,2.186812204
2514,LP6005442-DNA_C11,22,11614,29260,29260,0.39692,20675,8585,2.408270239
2515,LP6005442-DNA_C11,3,76658,180275,180275,0.42523,122018,58257,2.094477917
2516,LP6005442-DNA_C11,4,83502,191479,191479,0.43609,129450,62029,2.086927082
2517,LP6005442-DNA_C11,5,62314,156033,156033,0.39936,105390,50643,2.081037853
2518,LP6005442-DNA_C11,6,67453,166464,166464,0.40521,114268,52196,2.189209901
2519,LP6005442-DNA_C11,7,57740,137931,137931,0.41862,93932,43999,2.134866702
2520,LP6005442-DNA_C11,8,54860,134527,134527,0.4078,89161,45366,1.965370542
2521,LP6005442-DNA_C11,9,44701,105989,105989,0.42175,70604,35385,1.995308747
2522,LP6005442-DNA_C11,MT,44,49,49,0.89796,48,1,48
2523,LP6005442-DNA_C11,X,53525,54483,54483,0.98242,36658,17825,2.05654979
2524,LP6005442-DNA_C11,Y,693,745,745,0.9302,465,280,1.660714286
2525,LP6005442-DNA_D01,1,81596,188424,188424,0.43304,129870,58554,2.217952659
2526,LP6005442-DNA_D01,10,52378,123131,123131,0.42538,84646,38485,2.199454333
2527,LP6005442-DNA_D01,11,51495,120002,120002,0.42912,81549,38453,2.120744805
2528,LP6005442-DNA_D01,12,48850,113286,113286,0.43121,77780,35506,2.190615671
2529,LP6005442-DNA_D01,13,44079,94408,94408,0.4669,64336,30072,2.139398776
2530,LP6005442-DNA_D01,14,31134,77949,77949,0.39942,53253,24696,2.156341108
2531,LP6005442-DNA_D01,15,32621,70304,70304,0.464,47869,22435,2.133675061
2532,LP6005442-DNA_D01,16,28793,70343,70343,0.40932,45977,24366,1.886932611
2533,LP6005442-DNA_D01,17,23380,55065,55065,0.42459,38793,16272,2.384033923
2534,LP6005442-DNA_D01,18,31098,71960,71960,0.43216,49266,22694,2.170882171
2535,LP6005442-DNA_D01,19,14445,40619,40619,0.35562,28554,12065,2.366680481
2536,LP6005442-DNA_D01,2,88496,204345,204345,0.43307,138909,65436,2.1228223
2537,LP6005442-DNA_D01,20,20930,52098,52098,0.40174,36411,15687,2.321093899
2538,LP6005442-DNA_D01,21,14239,33952,33952,0.41939,23240,10712,2.1695295
2539,LP6005442-DNA_D01,22,10284,27279,27279,0.37699,19247,8032,2.396289841
2540,LP6005442-DNA_D01,3,73942,171286,171286,0.43169,115794,55492,2.086679161
2541,LP6005442-DNA_D01,4,78148,180012,180012,0.43413,121656,58356,2.084721365
2542,LP6005442-DNA_D01,5,55710,150867,150867,0.36927,102149,48718,2.096740424
2543,LP6005442-DNA_D01,6,63997,156261,156261,0.40955,107029,49232,2.173972213
2544,LP6005442-DNA_D01,7,54350,134319,134319,0.40463,91489,42830,2.136096194
2545,LP6005442-DNA_D01,8,55374,131651,131651,0.42061,87231,44420,1.963777578
2546,LP6005442-DNA_D01,9,43698,104852,104852,0.41676,69939,34913,2.003236617
2547,LP6005442-DNA_D01,MT,41,44,44,0.93182,41,3,13.66666667
2548,LP6005442-DNA_D01,X,48158,50156,50156,0.96016,32779,17377,1.886344018
2549,LP6005442-DNA_D01,Y,909,1001,1001,0.90809,589,412,1.42961165
2550,LP6005442-DNA_D02,1,77580,192690,192690,0.40262,133068,59622,2.231860723
2551,LP6005442-DNA_D02,10,52270,129560,129560,0.40344,88961,40599,2.191211606
2552,LP6005442-DNA_D02,11,51688,129917,129917,0.39785,88214,41703,2.115291466
2553,LP6005442-DNA_D02,12,46481,119200,119200,0.38994,81804,37396,2.187506685
2554,LP6005442-DNA_D02,13,43712,102891,102891,0.42484,70135,32756,2.141134449
2555,LP6005442-DNA_D02,14,32412,83083,83083,0.39012,56762,26321,2.156529007
2556,LP6005442-DNA_D02,15,29518,75004,75004,0.39355,51076,23928,2.134570378
2557,LP6005442-DNA_D02,16,28384,73928,73928,0.38394,48557,25371,1.91387805
2558,LP6005442-DNA_D02,17,23089,60698,60698,0.38039,42954,17744,2.420761948
2559,LP6005442-DNA_D02,18,31544,76006,76006,0.41502,52079,23927,2.17657876
2560,LP6005442-DNA_D02,19,15034,45497,45497,0.33044,31920,13577,2.351034838
2561,LP6005442-DNA_D02,2,83995,212059,212059,0.39609,144452,67607,2.136642655
2562,LP6005442-DNA_D02,20,22244,54009,54009,0.41186,37756,16253,2.323017289
2563,LP6005442-DNA_D02,21,13581,36255,36255,0.3746,24820,11435,2.170529077
2564,LP6005442-DNA_D02,22,10355,28336,28336,0.36544,20122,8214,2.44971999
2565,LP6005442-DNA_D02,3,70800,183957,183957,0.38487,124405,59552,2.089014643
2566,LP6005442-DNA_D02,4,79871,192213,192213,0.41553,130027,62186,2.090936867
2567,LP6005442-DNA_D02,5,60603,161537,161537,0.37516,109374,52163,2.096773575
2568,LP6005442-DNA_D02,6,59579,163475,163475,0.36445,112093,51382,2.181561636
2569,LP6005442-DNA_D02,7,51178,140578,140578,0.36405,95848,44730,2.14281243
2570,LP6005442-DNA_D02,8,53182,144837,144837,0.36719,95922,48915,1.96099356
2571,LP6005442-DNA_D02,9,39412,103105,103105,0.38225,69024,34081,2.025292685
2572,LP6005442-DNA_D02,MT,10,11,11,0.90909,10,1,10
2573,LP6005442-DNA_D02,X,50513,51176,51176,0.98704,34403,16773,2.05109402
2574,LP6005442-DNA_D02,Y,665,681,681,0.97651,423,258,1.639534884
2575,LP6005442-DNA_D03,1,78391,193723,193723,0.40466,133655,60068,2.225061597
2576,LP6005442-DNA_D03,10,49778,128715,128715,0.38673,88653,40062,2.212895013
2577,LP6005442-DNA_D03,11,50709,127410,127410,0.398,86362,41048,2.10392711
2578,LP6005442-DNA_D03,12,45614,120650,120650,0.37807,82913,37737,2.197127488
2579,LP6005442-DNA_D03,13,43444,102534,102534,0.4237,69905,32629,2.14241932
2580,LP6005442-DNA_D03,14,33096,82238,82238,0.40244,56225,26013,2.16141929
2581,LP6005442-DNA_D03,15,28592,73472,73472,0.38916,50049,23423,2.136745933
2582,LP6005442-DNA_D03,16,29057,72052,72052,0.40328,47178,24874,1.896679263
2583,LP6005442-DNA_D03,17,22084,59955,59955,0.36834,42370,17585,2.409439864
2584,LP6005442-DNA_D03,18,29781,75025,75025,0.39695,51506,23519,2.189974064
2585,LP6005442-DNA_D03,19,16032,44213,44213,0.36261,31154,13059,2.385634428
2586,LP6005442-DNA_D03,2,84395,215302,215302,0.39198,146324,68978,2.121314042
2587,LP6005442-DNA_D03,20,18303,54816,54816,0.3339,38186,16630,2.296211666
2588,LP6005442-DNA_D03,21,14819,36286,36286,0.40839,24857,11429,2.174905941
2589,LP6005442-DNA_D03,22,8852,29704,29704,0.29801,21109,8595,2.455962769
2590,LP6005442-DNA_D03,3,69892,181524,181524,0.38503,123093,58431,2.106638599
2591,LP6005442-DNA_D03,4,80316,196378,196378,0.40899,132948,63430,2.09597982
2592,LP6005442-DNA_D03,5,57781,161506,161506,0.35776,109242,52264,2.090195928
2593,LP6005442-DNA_D03,6,59410,166420,166420,0.35699,113824,52596,2.164118944
2594,LP6005442-DNA_D03,7,50983,135940,135940,0.37504,92554,43386,2.133268796
2595,LP6005442-DNA_D03,8,51807,139763,139763,0.37068,92653,47110,1.966737423
2596,LP6005442-DNA_D03,9,39150,108058,108058,0.36231,72312,35746,2.02293963
2597,LP6005442-DNA_D03,MT,26,29,29,0.89655,27,2,13.5
2598,LP6005442-DNA_D03,X,49462,50082,50082,0.98762,33729,16353,2.062557329
2599,LP6005442-DNA_D03,Y,734,752,752,0.97606,468,284,1.647887324
2600,LP6005442-DNA_D08,1,75143,194923,194923,0.3855,134703,60220,2.236848223
2601,LP6005442-DNA_D08,10,44824,123315,123315,0.36349,84971,38344,2.216018151
2602,LP6005442-DNA_D08,11,51060,125322,125322,0.40743,84901,40421,2.1004181
2603,LP6005442-DNA_D08,12,48094,114166,114166,0.42126,78483,35683,2.199450719
2604,LP6005442-DNA_D08,13,43890,97697,97697,0.44925,66780,30917,2.159976712
2605,LP6005442-DNA_D08,14,31104,79755,79755,0.38999,54541,25214,2.163123661
2606,LP6005442-DNA_D08,15,28308,71323,71323,0.3969,48570,22753,2.134663561
2607,LP6005442-DNA_D08,16,27050,71274,71274,0.37952,46670,24604,1.896846041
2608,LP6005442-DNA_D08,17,22051,57822,57822,0.38136,40931,16891,2.423243147
2609,LP6005442-DNA_D08,18,31065,74050,74050,0.41951,50702,23348,2.171577865
2610,LP6005442-DNA_D08,19,14010,41382,41382,0.33855,29209,12173,2.399490676
2611,LP6005442-DNA_D08,2,83653,207994,207994,0.40219,141440,66554,2.125191574
2612,LP6005442-DNA_D08,20,18738,51602,51602,0.36313,36029,15573,2.313555513
2613,LP6005442-DNA_D08,21,13132,35001,35001,0.37519,23933,11068,2.162359957
2614,LP6005442-DNA_D08,22,9152,27539,27539,0.33233,19532,8007,2.439365555
2615,LP6005442-DNA_D08,3,67880,180655,180655,0.37574,122068,58587,2.08353389
2616,LP6005442-DNA_D08,4,77493,187494,187494,0.41331,126636,60858,2.080843932
2617,LP6005442-DNA_D08,5,57568,154747,154747,0.37201,104368,50379,2.071656841
2618,LP6005442-DNA_D08,6,60477,163548,163548,0.36978,111890,51658,2.165976228
2619,LP6005442-DNA_D08,7,48056,135712,135712,0.3541,92687,43025,2.154259152
2620,LP6005442-DNA_D08,8,50881,134063,134063,0.37953,88850,45213,1.965142769
2621,LP6005442-DNA_D08,9,37993,104800,104800,0.36253,70085,34715,2.018867925
2622,LP6005442-DNA_D08,MT,34,35,35,0.97143,34,1,34
2623,LP6005442-DNA_D08,X,25048,70033,70033,0.35766,47313,22720,2.08243838
2624,LP6005442-DNA_D09,1,93983,203187,203187,0.46254,140361,62826,2.234122815
2625,LP6005442-DNA_D09,10,50791,143788,143788,0.35324,98954,44834,2.207119597
2626,LP6005442-DNA_D09,11,50152,139079,139079,0.3606,94497,44582,2.119622269
2627,LP6005442-DNA_D09,12,47637,129279,129279,0.36848,88813,40466,2.194756092
2628,LP6005442-DNA_D09,13,38802,110834,110834,0.35009,75621,35213,2.147530741
2629,LP6005442-DNA_D09,14,31704,93330,93330,0.3397,63785,29545,2.158910137
2630,LP6005442-DNA_D09,15,30428,80775,80775,0.3767,54835,25940,2.113916731
2631,LP6005442-DNA_D09,16,33930,80958,80958,0.41911,53260,27698,1.922882519
2632,LP6005442-DNA_D09,17,22578,69954,69954,0.32275,49300,20654,2.386946838
2633,LP6005442-DNA_D09,18,32367,87277,87277,0.37085,59735,27542,2.168869363
2634,LP6005442-DNA_D09,19,16694,53039,53039,0.31475,37403,15636,2.392107956
2635,LP6005442-DNA_D09,2,84611,244701,244701,0.34577,166122,78579,2.11407628
2636,LP6005442-DNA_D09,20,20583,63955,63955,0.32184,44804,19151,2.339512297
2637,LP6005442-DNA_D09,21,15487,40822,40822,0.37938,27864,12958,2.150331841
2638,LP6005442-DNA_D09,22,10956,34513,34513,0.31745,24408,10105,2.415437902
2639,LP6005442-DNA_D09,3,70490,208948,208948,0.33736,141661,67287,2.105324951
2640,LP6005442-DNA_D09,4,93490,197825,197825,0.47259,133364,64461,2.068909883
2641,LP6005442-DNA_D09,5,64192,182101,182101,0.35251,122753,59348,2.068359507
2642,LP6005442-DNA_D09,6,65217,187345,187345,0.34811,128448,58897,2.180892066
2643,LP6005442-DNA_D09,7,54935,162764,162764,0.33751,110725,52039,2.127731125
2644,LP6005442-DNA_D09,8,55417,164873,164873,0.33612,109163,55710,1.959486627
2645,LP6005442-DNA_D09,9,40767,119060,119060,0.34241,79586,39474,2.016162537
2646,LP6005442-DNA_D09,MT,46,47,47,0.97872,45,2,22.5
2647,LP6005442-DNA_D09,X,30960,90449,90449,0.34229,61260,29189,2.098735825
2648,LP6005442-DNA_D10,1,76000,197542,197542,0.38473,136232,61310,2.222019246
2649,LP6005442-DNA_D10,10,50999,124918,124918,0.40826,86090,38828,2.217214381
2650,LP6005442-DNA_D10,11,53069,126274,126274,0.42027,85702,40572,2.112343488
2651,LP6005442-DNA_D10,12,45595,119527,119527,0.38146,82289,37238,2.209812557
2652,LP6005442-DNA_D10,13,43986,102066,102066,0.43096,69323,32743,2.117185353
2653,LP6005442-DNA_D10,14,32788,81111,81111,0.40424,55482,25629,2.164813297
2654,LP6005442-DNA_D10,15,28825,75305,75305,0.38278,51245,24060,2.129883624
2655,LP6005442-DNA_D10,16,27373,76181,76181,0.35932,49942,26239,1.903349975
2656,LP6005442-DNA_D10,17,24325,63451,63451,0.38337,44723,18728,2.38802862
2657,LP6005442-DNA_D10,18,30886,76982,76982,0.40121,52689,24293,2.16889639
2658,LP6005442-DNA_D10,19,15418,42320,42320,0.36432,29758,12562,2.368890304
2659,LP6005442-DNA_D10,2,86299,213227,213227,0.40473,144932,68295,2.12214657
2660,LP6005442-DNA_D10,20,18777,53415,53415,0.35153,37325,16090,2.319763828
2661,LP6005442-DNA_D10,21,15265,35930,35930,0.42485,24483,11447,2.138813663
2662,LP6005442-DNA_D10,22,11303,30369,30369,0.37219,21585,8784,2.457308743
2663,LP6005442-DNA_D10,3,71507,183308,183308,0.39009,123914,59394,2.086305014
2664,LP6005442-DNA_D10,4,76393,192373,192373,0.39711,130114,62259,2.089882587
2665,LP6005442-DNA_D10,5,60198,158672,158672,0.37939,107265,51407,2.086583539
2666,LP6005442-DNA_D10,6,58718,166424,166424,0.35282,114110,52314,2.181251673
2667,LP6005442-DNA_D10,7,52111,139491,139491,0.37358,95106,44385,2.142750929
2668,LP6005442-DNA_D10,8,52447,138527,138527,0.3786,91678,46849,1.956882751
2669,LP6005442-DNA_D10,9,40266,106909,106909,0.37664,71276,35633,2.000280639
2670,LP6005442-DNA_D10,MT,25,30,30,0.83333,28,2,14
2671,LP6005442-DNA_D10,X,26227,67241,67241,0.39004,45545,21696,2.099234882
2672,LP6005442-DNA_D11,1,86689,196059,196059,0.44216,134961,61098,2.208926642
2673,LP6005442-DNA_D11,10,57026,125949,125949,0.45277,86409,39540,2.185356601
2674,LP6005442-DNA_D11,11,55350,125030,125030,0.44269,84909,40121,2.116323123
2675,LP6005442-DNA_D11,12,52708,121657,121657,0.43325,83675,37982,2.203017219
2676,LP6005442-DNA_D11,13,45715,101650,101650,0.44973,69301,32349,2.142291879
2677,LP6005442-DNA_D11,14,36066,84577,84577,0.42643,57783,26794,2.156564903
2678,LP6005442-DNA_D11,15,31993,74901,74901,0.42714,50988,23913,2.132229331
2679,LP6005442-DNA_D11,16,31885,75730,75730,0.42104,49802,25928,1.920780623
2680,LP6005442-DNA_D11,17,25152,61788,61788,0.40707,43568,18220,2.391218441
2681,LP6005442-DNA_D11,18,33472,76481,76481,0.43765,52442,24039,2.181538334
2682,LP6005442-DNA_D11,19,18271,44896,44896,0.40696,31571,13325,2.369305816
2683,LP6005442-DNA_D11,2,94119,213173,213173,0.44151,144659,68514,2.111378696
2684,LP6005442-DNA_D11,20,21309,54815,54815,0.38874,38331,16484,2.32534579
2685,LP6005442-DNA_D11,21,14554,35426,35426,0.41083,24097,11329,2.127019154
2686,LP6005442-DNA_D11,22,12579,29024,29024,0.4334,20546,8478,2.423448927
2687,LP6005442-DNA_D11,3,78302,185118,185118,0.42298,125143,59975,2.086586078
2688,LP6005442-DNA_D11,4,84578,195000,195000,0.43373,131696,63304,2.080374068
2689,LP6005442-DNA_D11,5,61406,158564,158564,0.38726,107042,51522,2.077597919
2690,LP6005442-DNA_D11,6,69915,171340,171340,0.40805,117325,54015,2.172081829
2691,LP6005442-DNA_D11,7,58054,141518,141518,0.41022,96307,45211,2.130167437
2692,LP6005442-DNA_D11,8,60365,139499,139499,0.43273,92429,47070,1.963649883
2693,LP6005442-DNA_D11,9,47041,110076,110076,0.42735,73644,36432,2.02140975
2694,LP6005442-DNA_D11,MT,31,34,34,0.91176,33,1,33
2695,LP6005442-DNA_D11,X,31571,68165,68165,0.46316,46106,22059,2.090121946
2696,LP6005442-DNA_E04,1,75163,209046,209046,0.35955,145084,63962,2.268284294
2697,LP6005442-DNA_E04,10,52284,136261,136261,0.3837,93921,42340,2.218256967
2698,LP6005442-DNA_E04,11,49825,128006,128006,0.38924,87533,40473,2.162750476
2699,LP6005442-DNA_E04,12,47641,122112,122112,0.39014,84273,37839,2.227146595
2700,LP6005442-DNA_E04,13,43503,101812,101812,0.42729,69736,32076,2.174086544
2701,LP6005442-DNA_E04,14,31300,83685,83685,0.37402,57477,26208,2.193108974
2702,LP6005442-DNA_E04,15,30982,81189,81189,0.3816,55403,25786,2.148568991
2703,LP6005442-DNA_E04,16,32120,85822,85822,0.37426,56331,29491,1.910108169
2704,LP6005442-DNA_E04,17,25673,73888,73888,0.34746,52251,21637,2.414891159
2705,LP6005442-DNA_E04,18,32208,76617,76617,0.42038,52742,23875,2.209089005
2706,LP6005442-DNA_E04,19,19190,53934,53934,0.35581,37901,16033,2.36393688
2707,LP6005442-DNA_E04,2,82743,218355,218355,0.37894,148844,69511,2.141301377
2708,LP6005442-DNA_E04,20,19857,61078,61078,0.32511,42782,18296,2.338325317
2709,LP6005442-DNA_E04,21,14842,37628,37628,0.39444,25678,11950,2.148786611
2710,LP6005442-DNA_E04,22,12538,35680,35680,0.3514,25319,10361,2.443683042
2711,LP6005442-DNA_E04,3,65322,175882,175882,0.3714,119238,56644,2.105042017
2712,LP6005442-DNA_E04,4,69166,181307,181307,0.38149,123433,57874,2.132788472
2713,LP6005442-DNA_E04,5,57718,156454,156454,0.36891,106270,50184,2.117607205
2714,LP6005442-DNA_E04,6,57530,169002,169002,0.34041,116364,52638,2.210646301
2715,LP6005442-DNA_E04,7,50287,146783,146783,0.34259,100419,46364,2.165883013
2716,LP6005442-DNA_E04,8,54502,147455,147455,0.36962,97831,49624,1.971445268
2717,LP6005442-DNA_E04,9,39824,110570,110570,0.36017,74347,36223,2.052480468
2718,LP6005442-DNA_E04,MT,11,12,12,0.91667,NA,NA,NA
2719,LP6005442-DNA_E04,X,49506,50404,50404,0.98218,33927,16477,2.059052012
2720,LP6005442-DNA_E04,Y,637,723,723,0.88105,451,272,1.658088235
2721,LP6005442-DNA_E07,1,91079,190606,190606,0.47784,131265,59341,2.212045635
2722,LP6005442-DNA_E07,10,61297,120218,120218,0.50988,82682,37536,2.202738704
2723,LP6005442-DNA_E07,11,59838,120274,120274,0.49751,81450,38824,2.097929116
2724,LP6005442-DNA_E07,12,54478,119590,119590,0.45554,82034,37556,2.184311428
2725,LP6005442-DNA_E07,13,47974,98351,98351,0.48778,66964,31387,2.133494759
2726,LP6005442-DNA_E07,14,36995,84014,84014,0.44034,57631,26383,2.184399045
2727,LP6005442-DNA_E07,15,36357,70905,70905,0.51276,48181,22724,2.120269319
2728,LP6005442-DNA_E07,16,33403,69826,69826,0.47837,45668,24158,1.890388277
2729,LP6005442-DNA_E07,17,27121,57960,57960,0.46793,40881,17079,2.393641314
2730,LP6005442-DNA_E07,18,34347,77029,77029,0.4459,52652,24377,2.159904828
2731,LP6005442-DNA_E07,19,17246,41176,41176,0.41884,28877,12299,2.347914465
2732,LP6005442-DNA_E07,2,97334,207539,207539,0.46899,140751,66788,2.107429478
2733,LP6005442-DNA_E07,20,24049,50414,50414,0.47703,35170,15244,2.307137234
2734,LP6005442-DNA_E07,21,15888,34930,34930,0.45485,23753,11177,2.125167755
2735,LP6005442-DNA_E07,22,12415,28005,28005,0.44331,19796,8209,2.411499574
2736,LP6005442-DNA_E07,3,82363,180940,180940,0.4552,122228,58712,2.081823137
2737,LP6005442-DNA_E07,4,91766,188285,188285,0.48738,127169,61116,2.08078081
2738,LP6005442-DNA_E07,5,72413,149813,149813,0.48336,100827,48986,2.058281958
2739,LP6005442-DNA_E07,6,73626,162977,162977,0.45176,111318,51659,2.154861689
2740,LP6005442-DNA_E07,7,63233,137141,137141,0.46108,93133,44008,2.116274314
2741,LP6005442-DNA_E07,8,60113,137398,137398,0.43751,90948,46450,1.957976319
2742,LP6005442-DNA_E07,9,50040,103744,103744,0.48234,69318,34426,2.013536281
2743,LP6005442-DNA_E07,MT,25,27,27,0.92593,24,3,8
2744,LP6005442-DNA_E07,X,51069,52002,52002,0.98206,34862,17140,2.033955659
2745,LP6005442-DNA_E07,Y,656,694,694,0.94524,443,251,1.764940239
2746,LP6005442-DNA_E10,1,78707,192898,192898,0.40802,132993,59905,2.220065103
2747,LP6005442-DNA_E10,10,50939,128722,128722,0.39573,88655,40067,2.21266878
2748,LP6005442-DNA_E10,11,51901,126441,126441,0.41048,85861,40580,2.115845244
2749,LP6005442-DNA_E10,12,48654,116077,116077,0.41915,79878,36199,2.206635542
2750,LP6005442-DNA_E10,13,43988,103118,103118,0.42658,70296,32822,2.141734203
2751,LP6005442-DNA_E10,14,32654,79481,79481,0.41084,54564,24917,2.189830236
2752,LP6005442-DNA_E10,15,29829,74576,74576,0.39998,50671,23905,2.119682075
2753,LP6005442-DNA_E10,16,28200,74966,74966,0.37617,49215,25751,1.911187915
2754,LP6005442-DNA_E10,17,24287,61504,61504,0.39488,43450,18054,2.406668882
2755,LP6005442-DNA_E10,18,30016,77300,77300,0.38831,52995,24305,2.180415552
2756,LP6005442-DNA_E10,19,15293,42227,42227,0.36216,29563,12664,2.334412508
2757,LP6005442-DNA_E10,2,84366,212865,212865,0.39634,144424,68441,2.110197104
2758,LP6005442-DNA_E10,20,18610,53538,53538,0.3476,37415,16123,2.320597904
2759,LP6005442-DNA_E10,21,14643,35452,35452,0.41304,24172,11280,2.142907801
2760,LP6005442-DNA_E10,22,10789,26427,26427,0.40826,18771,7656,2.451802508
2761,LP6005442-DNA_E10,3,71730,182566,182566,0.3929,123497,59069,2.090724407
2762,LP6005442-DNA_E10,4,80918,194639,194639,0.41573,131860,62779,2.100383886
2763,LP6005442-DNA_E10,5,58246,159204,159204,0.36586,107635,51569,2.087203553
2764,LP6005442-DNA_E10,6,62301,165259,165259,0.37699,113222,52037,2.17579799
2765,LP6005442-DNA_E10,7,53012,139316,139316,0.38052,94721,44595,2.124027357
2766,LP6005442-DNA_E10,8,49457,136833,136833,0.36144,90626,46207,1.961304564
2767,LP6005442-DNA_E10,9,39226,104588,104588,0.37505,69923,34665,2.017106592
2768,LP6005442-DNA_E10,MT,11,13,13,0.84615,NA,NA,NA
2769,LP6005442-DNA_E10,X,49075,49819,49819,0.98507,33496,16323,2.052073761
2770,LP6005442-DNA_E10,Y,134,161,161,0.8323,91,70,1.3
2771,LP6005442-DNA_E11,1,78527,236188,236188,0.33248,163189,72999,2.235496377
2772,LP6005442-DNA_E11,10,50928,151835,151835,0.33542,104243,47592,2.190347117
2773,LP6005442-DNA_E11,11,49155,149632,149632,0.32851,101617,48015,2.116359471
2774,LP6005442-DNA_E11,12,45131,141290,141290,0.31942,97163,44127,2.201894532
2775,LP6005442-DNA_E11,13,39494,116529,116529,0.33892,79307,37222,2.130648541
2776,LP6005442-DNA_E11,14,34620,100954,100954,0.34293,69074,31880,2.166687578
2777,LP6005442-DNA_E11,15,28761,88862,88862,0.32366,60500,28362,2.133135886
2778,LP6005442-DNA_E11,16,32572,93776,93776,0.34734,61412,32364,1.897540477
2779,LP6005442-DNA_E11,17,25725,76827,76827,0.33484,54230,22597,2.39987609
2780,LP6005442-DNA_E11,18,29720,88164,88164,0.3371,60528,27636,2.190186713
2781,LP6005442-DNA_E11,19,18973,59115,59115,0.32095,41597,17518,2.374529056
2782,LP6005442-DNA_E11,2,89753,260806,260806,0.34414,177095,83711,2.115552317
2783,LP6005442-DNA_E11,20,22248,68502,68502,0.32478,47660,20842,2.286728721
2784,LP6005442-DNA_E11,21,15463,44590,44590,0.34678,30375,14215,2.136827295
2785,LP6005442-DNA_E11,22,12611,37108,37108,0.33985,26319,10789,2.439429048
2786,LP6005442-DNA_E11,3,76181,228299,228299,0.33369,154334,73965,2.086581491
2787,LP6005442-DNA_E11,4,77272,229132,229132,0.33724,154367,74765,2.064696048
2788,LP6005442-DNA_E11,5,64520,206806,206806,0.31198,140152,66654,2.102679509
2789,LP6005442-DNA_E11,6,65201,198675,198675,0.32818,135875,62800,2.16361465
2790,LP6005442-DNA_E11,7,59881,176484,176484,0.3393,119782,56702,2.112482805
2791,LP6005442-DNA_E11,8,58170,175201,175201,0.33202,115883,59318,1.95358913
2792,LP6005442-DNA_E11,9,41373,130286,130286,0.31756,86877,43409,2.001359165
2793,LP6005442-DNA_E11,MT,37,39,39,0.94872,38,1,38
2794,LP6005442-DNA_E11,X,69249,70293,70293,0.98515,47289,23004,2.055685968
2795,LP6005442-DNA_E11,Y,948,978,978,0.96933,601,377,1.594164456
2796,LP6005442-DNA_E12,1,79944,197970,197970,0.40382,136372,61598,2.213903049
2797,LP6005442-DNA_E12,10,52233,132099,132099,0.39541,91011,41088,2.215026285
2798,LP6005442-DNA_E12,11,54648,128357,128357,0.42575,86923,41434,2.097866486
2799,LP6005442-DNA_E12,12,48295,122923,122923,0.39289,84342,38581,2.186101967
2800,LP6005442-DNA_E12,13,45942,103838,103838,0.44244,70732,33106,2.136531142
2801,LP6005442-DNA_E12,14,33142,85411,85411,0.38803,58389,27022,2.160794908
2802,LP6005442-DNA_E12,15,28267,73922,73922,0.38239,50267,23655,2.125005284
2803,LP6005442-DNA_E12,16,28304,74494,74494,0.37995,48678,25816,1.885574837
2804,LP6005442-DNA_E12,17,22964,60403,60403,0.38018,42771,17632,2.425759982
2805,LP6005442-DNA_E12,18,32124,78949,78949,0.4069,54052,24897,2.171024621
2806,LP6005442-DNA_E12,19,13516,42022,42022,0.32164,29527,12495,2.363105242
2807,LP6005442-DNA_E12,2,92048,216358,216358,0.42544,146687,69671,2.105424065
2808,LP6005442-DNA_E12,20,20098,52004,52004,0.38647,36420,15584,2.33701232
2809,LP6005442-DNA_E12,21,14703,36138,36138,0.40686,24595,11543,2.13072858
2810,LP6005442-DNA_E12,22,9938,28984,28984,0.34288,20665,8319,2.484072605
2811,LP6005442-DNA_E12,3,79027,181207,181207,0.43611,122388,58819,2.080756218
2812,LP6005442-DNA_E12,4,81580,195930,195930,0.41637,132601,63329,2.093843263
2813,LP6005442-DNA_E12,5,59846,162853,162853,0.36748,109980,52873,2.080078679
2814,LP6005442-DNA_E12,6,66016,168737,168737,0.39124,115575,53162,2.174015274
2815,LP6005442-DNA_E12,7,55412,144523,144523,0.38341,98409,46114,2.134037386
2816,LP6005442-DNA_E12,8,57945,141025,141025,0.41088,93270,47755,1.953093917
2817,LP6005442-DNA_E12,9,46461,105004,105004,0.44247,70339,34665,2.029107169
2818,LP6005442-DNA_E12,MT,45,47,47,0.95745,45,2,22.5
2819,LP6005442-DNA_E12,X,29653,76168,76168,0.38931,51528,24640,2.091233766
2820,LP6005442-DNA_F01,1,78856,182429,182429,0.43226,125581,56848,2.209066282
2821,LP6005442-DNA_F01,10,49238,116623,116623,0.4222,80210,36413,2.20278472
2822,LP6005442-DNA_F01,11,51036,114516,114516,0.44567,77677,36839,2.108553435
2823,LP6005442-DNA_F01,12,45201,112509,112509,0.40175,77154,35355,2.182265592
2824,LP6005442-DNA_F01,13,41020,91228,91228,0.44964,62210,29018,2.143841753
2825,LP6005442-DNA_F01,14,30474,75551,75551,0.40336,51711,23840,2.16908557
2826,LP6005442-DNA_F01,15,27104,67972,67972,0.39875,46245,21727,2.128457679
2827,LP6005442-DNA_F01,16,28577,67147,67147,0.42559,43910,23237,1.889658734
2828,LP6005442-DNA_F01,17,24602,54039,54039,0.45526,38088,15951,2.387812676
2829,LP6005442-DNA_F01,18,30889,70239,70239,0.43977,48174,22065,2.183276683
2830,LP6005442-DNA_F01,19,14274,39675,39675,0.35977,27845,11830,2.353761623
2831,LP6005442-DNA_F01,2,90855,191918,191918,0.47341,130248,61670,2.112015567
2832,LP6005442-DNA_F01,20,18365,48647,48647,0.37752,33985,14662,2.317896603
2833,LP6005442-DNA_F01,21,14579,31626,31626,0.46098,21551,10075,2.139057072
2834,LP6005442-DNA_F01,22,12449,25208,25208,0.49385,17832,7376,2.417570499
2835,LP6005442-DNA_F01,3,75628,167657,167657,0.45109,113255,54402,2.081816845
2836,LP6005442-DNA_F01,4,74567,172156,172156,0.43314,116027,56129,2.067148889
2837,LP6005442-DNA_F01,5,54674,146274,146274,0.37378,98781,47493,2.079906513
2838,LP6005442-DNA_F01,6,62352,152240,152240,0.40956,104109,48131,2.163034219
2839,LP6005442-DNA_F01,7,52746,128675,128675,0.40992,87504,41171,2.125379515
2840,LP6005442-DNA_F01,8,53258,124402,124402,0.42811,82470,41932,1.9667557
2841,LP6005442-DNA_F01,9,39444,97085,97085,0.40628,64835,32250,2.010387597
2842,LP6005442-DNA_F01,MT,38,42,42,0.90476,NA,NA,NA
2843,LP6005442-DNA_F01,X,25660,64120,64120,0.40019,43021,21099,2.039006588
2844,LP6005442-DNA_F02,1,80123,192424,192424,0.41639,132853,59571,2.230162327
2845,LP6005442-DNA_F02,10,51885,125402,125402,0.41375,86316,39086,2.20836105
2846,LP6005442-DNA_F02,11,53648,123736,123736,0.43357,83839,39897,2.101386069
2847,LP6005442-DNA_F02,12,48175,119142,119142,0.40435,81825,37317,2.192700378
2848,LP6005442-DNA_F02,13,43716,101836,101836,0.42928,69343,32493,2.134090419
2849,LP6005442-DNA_F02,14,33991,83987,83987,0.40472,57249,26738,2.141110031
2850,LP6005442-DNA_F02,15,28365,74057,74057,0.38302,50432,23625,2.134687831
2851,LP6005442-DNA_F02,16,28802,74224,74224,0.38804,48741,25483,1.912686889
2852,LP6005442-DNA_F02,17,22877,59267,59267,0.386,41790,17477,2.391142645
2853,LP6005442-DNA_F02,18,32386,74286,74286,0.43596,51026,23260,2.19372313
2854,LP6005442-DNA_F02,19,14885,44035,44035,0.33803,31052,12983,2.391743049
2855,LP6005442-DNA_F02,2,86770,209679,209679,0.41382,142512,67167,2.12175622
2856,LP6005442-DNA_F02,20,18334,51593,51593,0.35536,35898,15695,2.287225231
2857,LP6005442-DNA_F02,21,13280,35869,35869,0.37024,24518,11351,2.159985904
2858,LP6005442-DNA_F02,22,10555,29750,29750,0.35479,21039,8711,2.415222133
2859,LP6005442-DNA_F02,3,74200,183641,183641,0.40405,123993,59648,2.078745306
2860,LP6005442-DNA_F02,4,81862,192663,192663,0.4249,130130,62533,2.080981242
2861,LP6005442-DNA_F02,5,58103,154751,154751,0.37546,104524,50227,2.081032114
2862,LP6005442-DNA_F02,6,58665,165112,165112,0.3553,113010,52102,2.169014625
2863,LP6005442-DNA_F02,7,54663,138248,138248,0.3954,93822,44426,2.111871427
2864,LP6005442-DNA_F02,8,54175,137315,137315,0.39453,90941,46374,1.9610342
2865,LP6005442-DNA_F02,9,40391,101903,101903,0.39637,68080,33823,2.012831505
2866,LP6005442-DNA_F02,MT,40,43,43,0.93023,42,1,42
2867,LP6005442-DNA_F02,X,51972,52626,52626,0.98757,35359,17267,2.047779
2868,LP6005442-DNA_F02,Y,374,392,392,0.95408,244,148,1.648648649
2869,LP6005442-DNA_F04,1,75034,196277,196277,0.38229,135176,61101,2.21233695
2870,LP6005442-DNA_F04,10,48889,130937,130937,0.37338,90178,40759,2.212468412
2871,LP6005442-DNA_F04,11,53491,126899,126899,0.42152,86078,40821,2.108669557
2872,LP6005442-DNA_F04,12,57752,113475,113475,0.50894,77979,35496,2.19683908
2873,LP6005442-DNA_F04,13,45484,107757,107757,0.4221,73362,34395,2.132926297
2874,LP6005442-DNA_F04,14,32986,83423,83423,0.39541,57047,26376,2.162837428
2875,LP6005442-DNA_F04,15,28288,73740,73740,0.38362,50186,23554,2.130678441
2876,LP6005442-DNA_F04,16,27395,71105,71105,0.38528,46526,24579,1.892916718
2877,LP6005442-DNA_F04,17,21854,59502,59502,0.36728,41992,17510,2.398172473
2878,LP6005442-DNA_F04,18,30835,79888,79888,0.38598,54772,25116,2.180761268
2879,LP6005442-DNA_F04,19,16110,42898,42898,0.37554,30267,12631,2.396247328
2880,LP6005442-DNA_F04,2,96841,209001,209001,0.46335,141792,67209,2.109717449
2881,LP6005442-DNA_F04,20,18728,54642,54642,0.34274,38126,16516,2.308428191
2882,LP6005442-DNA_F04,21,13675,36975,36975,0.36984,25287,11688,2.163501027
2883,LP6005442-DNA_F04,22,12753,24023,24023,0.53087,17083,6940,2.461527378
2884,LP6005442-DNA_F04,3,70740,187572,187572,0.37714,126764,60808,2.084659913
2885,LP6005442-DNA_F04,4,88152,193654,193654,0.4552,131092,62562,2.09539337
2886,LP6005442-DNA_F04,5,61507,175313,175313,0.35084,118304,57009,2.075181112
2887,LP6005442-DNA_F04,6,89891,143386,143386,0.62692,98317,45069,2.18147729
2888,LP6005442-DNA_F04,7,54812,147846,147846,0.37074,100637,47209,2.131733356
2889,LP6005442-DNA_F04,8,55493,145468,145468,0.38148,96370,49098,1.962809076
2890,LP6005442-DNA_F04,9,41667,109435,109435,0.38075,72882,36553,1.993871912
2891,LP6005442-DNA_F04,MT,14,16,16,0.875,15,1,15
2892,LP6005442-DNA_F04,X,52929,53756,53756,0.98462,36232,17524,2.067564483
2893,LP6005442-DNA_F04,Y,729,744,744,0.97984,458,286,1.601398601
2894,LP6005442-DNA_F09,1,76919,235682,235682,0.32637,162683,72999,2.228564775
2895,LP6005442-DNA_F09,10,50615,151367,151367,0.33439,104326,47041,2.217767479
2896,LP6005442-DNA_F09,11,51366,151670,151670,0.33867,103353,48317,2.139060786
2897,LP6005442-DNA_F09,12,48893,142555,142555,0.34298,98104,44451,2.207014465
2898,LP6005442-DNA_F09,13,40585,119165,119165,0.34058,81247,37918,2.142702674
2899,LP6005442-DNA_F09,14,34024,99470,99470,0.34205,68133,31337,2.174203019
2900,LP6005442-DNA_F09,15,29263,88685,88685,0.32997,60391,28294,2.134410122
2901,LP6005442-DNA_F09,16,30451,92086,92086,0.33068,60236,31850,1.891240188
2902,LP6005442-DNA_F09,17,25420,74245,74245,0.34238,52229,22016,2.372320131
2903,LP6005442-DNA_F09,18,30540,92998,92998,0.32839,63737,29261,2.178223574
2904,LP6005442-DNA_F09,19,17249,52062,52062,0.33132,36685,15377,2.385705924
2905,LP6005442-DNA_F09,2,87712,263649,263649,0.33268,179370,84279,2.128288186
2906,LP6005442-DNA_F09,20,20892,68739,68739,0.30393,47948,20791,2.306190178
2907,LP6005442-DNA_F09,21,16302,44390,44390,0.36724,30303,14087,2.15113225
2908,LP6005442-DNA_F09,22,11879,36838,36838,0.32247,26150,10688,2.446669162
2909,LP6005442-DNA_F09,3,76219,230162,230162,0.33115,155681,74481,2.090210926
2910,LP6005442-DNA_F09,4,80795,235642,235642,0.34287,159001,76641,2.074620634
2911,LP6005442-DNA_F09,5,67382,208067,208067,0.32385,140631,67436,2.08539949
2912,LP6005442-DNA_F09,6,67608,202610,202610,0.33369,138724,63886,2.17143036
2913,LP6005442-DNA_F09,7,61129,175695,175695,0.34793,119098,56597,2.104316483
2914,LP6005442-DNA_F09,8,58429,178778,178778,0.32682,118383,60395,1.960145707
2915,LP6005442-DNA_F09,9,44066,132537,132537,0.33248,88871,43666,2.035244813
2916,LP6005442-DNA_F09,MT,34,35,35,0.97143,34,1,34
2917,LP6005442-DNA_F09,X,35647,111071,111071,0.32094,74794,36277,2.061747112
2918,LP6005442-DNA_F10,1,76292,190198,190198,0.40112,131236,58962,2.225772531
2919,LP6005442-DNA_F10,10,50059,128334,128334,0.39007,88436,39898,2.216552208
2920,LP6005442-DNA_F10,11,54328,127010,127010,0.42775,86448,40562,2.131255855
2921,LP6005442-DNA_F10,12,46933,121495,121495,0.3863,83629,37866,2.208551207
2922,LP6005442-DNA_F10,13,42581,102989,102989,0.41345,70342,32647,2.154623702
2923,LP6005442-DNA_F10,14,32855,83344,83344,0.39421,57128,26216,2.179127251
2924,LP6005442-DNA_F10,15,29689,73160,73160,0.40581,49724,23436,2.121693122
2925,LP6005442-DNA_F10,16,28586,75208,75208,0.38009,49394,25814,1.913457814
2926,LP6005442-DNA_F10,17,23533,61169,61169,0.38472,43232,17937,2.410213525
2927,LP6005442-DNA_F10,18,32544,77422,77422,0.42035,53188,24234,2.194767682
2928,LP6005442-DNA_F10,19,16127,43758,43758,0.36855,30708,13050,2.353103448
2929,LP6005442-DNA_F10,2,85365,214767,214767,0.39748,146356,68411,2.139363553
2930,LP6005442-DNA_F10,20,19082,52151,52151,0.3659,36489,15662,2.329779083
2931,LP6005442-DNA_F10,21,14954,36129,36129,0.41391,24719,11410,2.166432954
2932,LP6005442-DNA_F10,22,9848,29055,29055,0.33894,20584,8471,2.429937434
2933,LP6005442-DNA_F10,3,71274,180890,180890,0.39402,122372,58518,2.091185618
2934,LP6005442-DNA_F10,4,77896,190573,190573,0.40875,129174,61399,2.10384534
2935,LP6005442-DNA_F10,5,59540,162230,162230,0.36701,109771,52459,2.092510341
2936,LP6005442-DNA_F10,6,61470,163121,163121,0.37684,111811,51310,2.179126876
2937,LP6005442-DNA_F10,7,51398,137081,137081,0.37495,93386,43695,2.137223939
2938,LP6005442-DNA_F10,8,52529,139097,139097,0.37764,92065,47032,1.957497023
2939,LP6005442-DNA_F10,9,40092,107054,107054,0.3745,71661,35393,2.024722403
2940,LP6005442-DNA_F10,MT,36,41,41,0.87805,39,2,19.5
2941,LP6005442-DNA_F10,X,28309,72798,72798,0.38887,49149,23649,2.078269694
2942,LP6005442-DNA_F11,1,75629,232223,232223,0.32567,160223,72000,2.225319444
2943,LP6005442-DNA_F11,10,50714,151064,151064,0.33571,104048,47016,2.213033861
2944,LP6005442-DNA_F11,11,50348,149569,149569,0.33662,102075,47494,2.149218849
2945,LP6005442-DNA_F11,12,45321,139888,139888,0.32398,96219,43669,2.203370812
2946,LP6005442-DNA_F11,13,38234,115872,115872,0.32997,79024,36848,2.144594008
2947,LP6005442-DNA_F11,14,32172,99069,99069,0.32474,67847,31222,2.173051054
2948,LP6005442-DNA_F11,15,28372,89605,89605,0.31663,61066,28539,2.139738603
2949,LP6005442-DNA_F11,16,32316,89628,89628,0.36056,58928,30700,1.919478827
2950,LP6005442-DNA_F11,17,24613,77190,77190,0.31886,54475,22715,2.398195025
2951,LP6005442-DNA_F11,18,28795,88108,88108,0.32681,60282,27826,2.166391145
2952,LP6005442-DNA_F11,19,18795,59469,59469,0.31605,41900,17569,2.384882463
2953,LP6005442-DNA_F11,2,90237,252818,252818,0.35692,171541,81277,2.110572487
2954,LP6005442-DNA_F11,20,22345,69106,69106,0.32334,48253,20853,2.313959622
2955,LP6005442-DNA_F11,21,15665,44227,44227,0.3542,30363,13864,2.190060589
2956,LP6005442-DNA_F11,22,12897,37350,37350,0.3453,26442,10908,2.424092409
2957,LP6005442-DNA_F11,3,74735,224851,224851,0.33238,151858,72993,2.08044607
2958,LP6005442-DNA_F11,4,78096,226505,226505,0.34479,152761,73744,2.071504122
2959,LP6005442-DNA_F11,5,64176,198095,198095,0.32397,134130,63965,2.096928008
2960,LP6005442-DNA_F11,6,67891,199095,199095,0.341,136698,62397,2.190778403
2961,LP6005442-DNA_F11,7,57691,169812,169812,0.33973,115128,54684,2.105332456
2962,LP6005442-DNA_F11,8,58449,174073,174073,0.33577,115309,58764,1.962238786
2963,LP6005442-DNA_F11,9,42125,130656,130656,0.32241,87373,43283,2.018644733
2964,LP6005442-DNA_F11,MT,51,53,53,0.96226,52,1,52
2965,LP6005442-DNA_F11,X,34049,108725,108725,0.31317,73305,35420,2.06959345
2966,LP6005442-DNA_F12,1,77553,194629,194629,0.39847,134099,60530,2.215413844
2967,LP6005442-DNA_F12,10,48811,128519,128519,0.3798,88548,39971,2.215306097
2968,LP6005442-DNA_F12,11,52613,126475,126475,0.416,85683,40792,2.100485389
2969,LP6005442-DNA_F12,12,50772,114219,114219,0.44451,78675,35544,2.213453747
2970,LP6005442-DNA_F12,13,46774,101689,101689,0.45997,69197,32492,2.129662686
2971,LP6005442-DNA_F12,14,33429,79264,79264,0.42174,54129,25135,2.153530933
2972,LP6005442-DNA_F12,15,30907,72926,72926,0.42381,49642,23284,2.132021989
2973,LP6005442-DNA_F12,16,28035,73170,73170,0.38315,47922,25248,1.898051331
2974,LP6005442-DNA_F12,17,24092,57362,57362,0.42,40385,16977,2.378806621
2975,LP6005442-DNA_F12,18,30406,76142,76142,0.39933,52091,24051,2.16585589
2976,LP6005442-DNA_F12,19,15204,42696,42696,0.3561,30066,12630,2.380522565
2977,LP6005442-DNA_F12,2,85475,212313,212313,0.40259,144160,68153,2.115240708
2978,LP6005442-DNA_F12,20,20148,52448,52448,0.38415,36510,15938,2.290751663
2979,LP6005442-DNA_F12,21,13617,35350,35350,0.38521,24194,11156,2.168698458
2980,LP6005442-DNA_F12,22,10597,28175,28175,0.37611,19922,8253,2.413910093
2981,LP6005442-DNA_F12,3,71293,186189,186189,0.38291,125881,60308,2.087301851
2982,LP6005442-DNA_F12,4,76146,193584,193584,0.39335,130837,62747,2.085151481
2983,LP6005442-DNA_F12,5,60982,154066,154066,0.39582,103851,50215,2.068127054
2984,LP6005442-DNA_F12,6,60796,160724,160724,0.37826,110121,50603,2.176175326
2985,LP6005442-DNA_F12,7,53170,143490,143490,0.37055,97661,45829,2.13098693
2986,LP6005442-DNA_F12,8,57870,132663,132663,0.43622,87981,44682,1.969047939
2987,LP6005442-DNA_F12,9,39182,104415,104415,0.37525,69647,34768,2.003192591
2988,LP6005442-DNA_F12,MT,40,42,42,0.95238,39,3,13
2989,LP6005442-DNA_F12,X,27661,75355,75355,0.36708,50772,24583,2.065329699
2990,LP6005442-DNA_G01,1,77557,181322,181322,0.42773,124650,56672,2.199498871
2991,LP6005442-DNA_G01,10,48666,115259,115259,0.42223,79050,36209,2.183158883
2992,LP6005442-DNA_G01,11,49664,115292,115292,0.43077,77965,37327,2.088702548
2993,LP6005442-DNA_G01,12,47169,109043,109043,0.43257,74687,34356,2.173914309
2994,LP6005442-DNA_G01,13,42419,93730,93730,0.45257,63607,30123,2.111575872
2995,LP6005442-DNA_G01,14,30696,75085,75085,0.40882,51100,23985,2.130498228
2996,LP6005442-DNA_G01,15,29333,67868,67868,0.43221,46160,21708,2.126405012
2997,LP6005442-DNA_G01,16,27637,65397,65397,0.4226,42850,22547,1.900474564
2998,LP6005442-DNA_G01,17,22084,51394,51394,0.4297,36205,15189,2.383632892
2999,LP6005442-DNA_G01,18,30804,68955,68955,0.44673,47338,21617,2.189850581
3000,LP6005442-DNA_G01,19,13222,35421,35421,0.37328,24802,10619,2.335624823
3001,LP6005442-DNA_G01,2,84239,195962,195962,0.42987,132940,63022,2.109422107
3002,LP6005442-DNA_G01,20,19825,48581,48581,0.40808,33759,14822,2.27762785
3003,LP6005442-DNA_G01,21,13553,32474,32474,0.41735,22166,10308,2.150368646
3004,LP6005442-DNA_G01,22,9810,25211,25211,0.38912,17845,7366,2.422617431
3005,LP6005442-DNA_G01,3,74542,169947,169947,0.43862,114728,55219,2.07769065
3006,LP6005442-DNA_G01,4,78152,177305,177305,0.44078,119577,57728,2.071386502
3007,LP6005442-DNA_G01,5,57467,142614,142614,0.40295,96043,46571,2.062291984
3008,LP6005442-DNA_G01,6,66090,149741,149741,0.44136,102289,47452,2.155630953
3009,LP6005442-DNA_G01,7,55210,128699,128699,0.42899,87118,41581,2.095139607
3010,LP6005442-DNA_G01,8,51772,129793,129793,0.39888,85836,43957,1.952726528
3011,LP6005442-DNA_G01,9,38682,97633,97633,0.3962,65131,32502,2.003907452
3012,LP6005442-DNA_G01,MT,29,32,32,0.90625,29,3,9.666666667
3013,LP6005442-DNA_G01,X,46920,48920,48920,0.95912,32334,16586,1.949475461
3014,LP6005442-DNA_G01,Y,569,635,635,0.89606,367,268,1.369402985
3015,LP6005442-DNA_G02,1,78344,192681,192681,0.4066,133035,59646,2.230409416
3016,LP6005442-DNA_G02,10,50847,125704,125704,0.4045,86377,39327,2.196379078
3017,LP6005442-DNA_G02,11,51794,129234,129234,0.40078,87680,41554,2.110025509
3018,LP6005442-DNA_G02,12,47212,119845,119845,0.39394,82312,37533,2.193056777
3019,LP6005442-DNA_G02,13,43665,102430,102430,0.42629,69814,32616,2.140483198
3020,LP6005442-DNA_G02,14,31997,83160,83160,0.38476,56858,26302,2.16173675
3021,LP6005442-DNA_G02,15,30059,74022,74022,0.40608,50404,23618,2.134134982
3022,LP6005442-DNA_G02,16,27076,71660,71660,0.37784,46926,24734,1.89722649
3023,LP6005442-DNA_G02,17,22318,62230,62230,0.35864,44039,18191,2.420922434
3024,LP6005442-DNA_G02,18,30623,77782,77782,0.3937,53353,24429,2.18400262
3025,LP6005442-DNA_G02,19,15901,43308,43308,0.36716,30438,12870,2.365034965
3026,LP6005442-DNA_G02,2,82068,210328,210328,0.39019,142872,67456,2.118002846
3027,LP6005442-DNA_G02,20,20875,50389,50389,0.41428,35053,15336,2.28566771
3028,LP6005442-DNA_G02,21,13779,35166,35166,0.39183,24100,11066,2.177842039
3029,LP6005442-DNA_G02,22,9543,28475,28475,0.33514,20233,8242,2.454865324
3030,LP6005442-DNA_G02,3,70572,180170,180170,0.3917,121822,58348,2.087852197
3031,LP6005442-DNA_G02,4,77259,197654,197654,0.39088,133741,63913,2.092547682
3032,LP6005442-DNA_G02,5,58022,162618,162618,0.3568,109731,52887,2.074819899
3033,LP6005442-DNA_G02,6,60215,163301,163301,0.36874,111926,51375,2.178608273
3034,LP6005442-DNA_G02,7,53170,139832,139832,0.38024,95269,44563,2.137849786
3035,LP6005442-DNA_G02,8,54349,141525,141525,0.38402,93858,47667,1.969035182
3036,LP6005442-DNA_G02,9,41302,108442,108442,0.38087,72338,36104,2.003600709
3037,LP6005442-DNA_G02,MT,25,25,25,1,NA,NA,NA
3038,LP6005442-DNA_G02,X,50531,51296,51296,0.98509,34513,16783,2.056426146
3039,LP6005442-DNA_G02,Y,708,735,735,0.96327,438,297,1.474747475
3040,LP6005442-DNA_G03,1,77770,191124,191124,0.40691,131916,59208,2.228009728
3041,LP6005442-DNA_G03,10,51189,124636,124636,0.41071,85870,38766,2.215085384
3042,LP6005442-DNA_G03,11,51557,130014,130014,0.39655,88295,41719,2.116421774
3043,LP6005442-DNA_G03,12,45895,118922,118922,0.38593,81660,37262,2.191508776
3044,LP6005442-DNA_G03,13,43787,100940,100940,0.43379,68980,31960,2.158322904
3045,LP6005442-DNA_G03,14,31331,80666,80666,0.3884,55250,25416,2.17382751
3046,LP6005442-DNA_G03,15,29465,72513,72513,0.40634,49316,23197,2.125964564
3047,LP6005442-DNA_G03,16,27420,72923,72923,0.37601,47688,25235,1.889756291
3048,LP6005442-DNA_G03,17,23205,59115,59115,0.39254,41799,17316,2.413894664
3049,LP6005442-DNA_G03,18,31351,76545,76545,0.40958,52602,23943,2.196967799
3050,LP6005442-DNA_G03,19,16685,42262,42262,0.3948,29691,12571,2.361864609
3051,LP6005442-DNA_G03,2,83076,212488,212488,0.39097,144613,67875,2.130578269
3052,LP6005442-DNA_G03,20,19754,51327,51327,0.38487,35736,15591,2.292091591
3053,LP6005442-DNA_G03,21,14143,34636,34636,0.40833,23673,10963,2.159354191
3054,LP6005442-DNA_G03,22,9627,28170,28170,0.34175,19999,8171,2.447558438
3055,LP6005442-DNA_G03,3,71903,180116,180116,0.3992,121850,58266,2.091271067
3056,LP6005442-DNA_G03,4,77750,189945,189945,0.40933,128537,61408,2.093163757
3057,LP6005442-DNA_G03,5,57698,159205,159205,0.36241,107635,51570,2.087163079
3058,LP6005442-DNA_G03,6,60561,161055,161055,0.37603,110362,50693,2.177065867
3059,LP6005442-DNA_G03,7,51132,139313,139313,0.36703,94641,44672,2.118575394
3060,LP6005442-DNA_G03,8,53729,137226,137226,0.39154,90838,46388,1.958221954
3061,LP6005442-DNA_G03,9,41516,106605,106605,0.38944,71242,35363,2.014591522
3062,LP6005442-DNA_G03,MT,13,14,14,0.92857,13,1,13
3063,LP6005442-DNA_G03,X,49156,50169,50169,0.97981,33592,16577,2.026422151
3064,LP6005442-DNA_G03,Y,675,708,708,0.95339,420,288,1.458333333
3065,LP6005442-DNA_G04,1,77917,193907,193907,0.40183,133778,60129,2.224849906
3066,LP6005442-DNA_G04,10,49402,129548,129548,0.38134,89179,40369,2.209096089
3067,LP6005442-DNA_G04,11,53449,128899,128899,0.41466,87220,41679,2.092660572
3068,LP6005442-DNA_G04,12,46615,121522,121522,0.38359,83608,37914,2.205201245
3069,LP6005442-DNA_G04,13,52418,95212,95212,0.55054,65052,30160,2.156896552
3070,LP6005442-DNA_G04,14,33000,82857,82857,0.39828,56647,26210,2.161274323
3071,LP6005442-DNA_G04,15,29011,72992,72992,0.39745,49777,23215,2.144174025
3072,LP6005442-DNA_G04,16,28126,74068,74068,0.37973,48641,25427,1.912966532
3073,LP6005442-DNA_G04,17,21859,61331,61331,0.35641,43379,17952,2.416388146
3074,LP6005442-DNA_G04,18,31100,78401,78401,0.39668,53701,24700,2.174129555
3075,LP6005442-DNA_G04,19,15771,47145,47145,0.33452,33245,13900,2.391726619
3076,LP6005442-DNA_G04,2,82246,218355,218355,0.37666,148180,70175,2.111578197
3077,LP6005442-DNA_G04,20,21036,53647,53647,0.39212,37465,16182,2.315226795
3078,LP6005442-DNA_G04,21,13932,38110,38110,0.36557,26024,12086,2.153235148
3079,LP6005442-DNA_G04,22,9507,29578,29578,0.32142,20995,8583,2.446114412
3080,LP6005442-DNA_G04,3,67522,186257,186257,0.36252,125712,60545,2.076339912
3081,LP6005442-DNA_G04,4,81996,196971,196971,0.41628,133185,63786,2.087997366
3082,LP6005442-DNA_G04,5,59723,162788,162788,0.36688,110113,52675,2.090422402
3083,LP6005442-DNA_G04,6,60374,167497,167497,0.36045,114577,52920,2.165098262
3084,LP6005442-DNA_G04,7,51788,139947,139947,0.37005,95258,44689,2.131576003
3085,LP6005442-DNA_G04,8,54884,140018,140018,0.39198,92837,47181,1.967677667
3086,LP6005442-DNA_G04,9,39965,107103,107103,0.37315,71577,35526,2.014777909
3087,LP6005442-DNA_G04,MT,26,28,28,0.92857,26,2,13
3088,LP6005442-DNA_G04,X,49934,50526,50526,0.98828,34031,16495,2.063110033
3089,LP6005442-DNA_G04,Y,141,167,167,0.84431,100,67,1.492537313
3090,LP6005442-DNA_G07,1,77707,193916,193916,0.40073,133822,60094,2.226877891
3091,LP6005442-DNA_G07,10,48565,128203,128203,0.37881,88281,39922,2.211337107
3092,LP6005442-DNA_G07,11,52005,130559,130559,0.39833,88579,41980,2.110028585
3093,LP6005442-DNA_G07,12,45715,119089,119089,0.38387,82060,37029,2.216100894
3094,LP6005442-DNA_G07,13,42844,102482,102482,0.41806,69988,32494,2.153874561
3095,LP6005442-DNA_G07,14,32407,83248,83248,0.38928,57080,26168,2.181290125
3096,LP6005442-DNA_G07,15,29945,72549,72549,0.41276,49475,23074,2.144188264
3097,LP6005442-DNA_G07,16,27197,73964,73964,0.36771,48366,25598,1.889444488
3098,LP6005442-DNA_G07,17,22257,60427,60427,0.36833,42755,17672,2.419363966
3099,LP6005442-DNA_G07,18,31176,77091,77091,0.40441,52822,24269,2.176521488
3100,LP6005442-DNA_G07,19,14920,42430,42430,0.35164,29901,12529,2.38654322
3101,LP6005442-DNA_G07,2,86309,210841,210841,0.40936,143089,67752,2.111952415
3102,LP6005442-DNA_G07,20,19814,53774,53774,0.36847,37560,16214,2.316516591
3103,LP6005442-DNA_G07,21,13178,35088,35088,0.37557,24012,11076,2.167930661
3104,LP6005442-DNA_G07,22,9286,28302,28302,0.3281,19972,8330,2.39759904
3105,LP6005442-DNA_G07,3,70136,185887,185887,0.3773,125762,60125,2.091675676
3106,LP6005442-DNA_G07,4,79747,190742,190742,0.41809,128959,61783,2.087289384
3107,LP6005442-DNA_G07,5,60285,164828,164828,0.36574,111511,53317,2.091471763
3108,LP6005442-DNA_G07,6,61083,163178,163178,0.37433,111994,51184,2.188066583
3109,LP6005442-DNA_G07,7,52023,137933,137933,0.37716,93878,44055,2.13092725
3110,LP6005442-DNA_G07,8,51989,142343,142343,0.36524,94316,48027,1.963812022
3111,LP6005442-DNA_G07,9,40597,105413,105413,0.38512,70526,34887,2.021555307
3112,LP6005442-DNA_G07,MT,13,16,16,0.8125,15,1,15
3113,LP6005442-DNA_G07,X,52295,53100,53100,0.98484,35673,17427,2.046996041
3114,LP6005442-DNA_G07,Y,1011,1041,1041,0.97118,666,375,1.776
3115,LP6005442-DNA_G09,1,79517,204549,204549,0.38874,141332,63217,2.235664457
3116,LP6005442-DNA_G09,10,49717,134738,134738,0.36899,92862,41876,2.217547044
3117,LP6005442-DNA_G09,11,51666,131745,131745,0.39217,89432,42313,2.113582114
3118,LP6005442-DNA_G09,12,48374,124237,124237,0.38937,85421,38816,2.200664674
3119,LP6005442-DNA_G09,13,42951,103444,103444,0.41521,70356,33088,2.126329787
3120,LP6005442-DNA_G09,14,32488,85268,85268,0.38101,58307,26961,2.162642335
3121,LP6005442-DNA_G09,15,28865,75943,75943,0.38009,51662,24281,2.127671842
3122,LP6005442-DNA_G09,16,29316,75450,75450,0.38855,49484,25966,1.905722868
3123,LP6005442-DNA_G09,17,22841,63788,63788,0.35808,45033,18755,2.401119701
3124,LP6005442-DNA_G09,18,31169,76413,76413,0.4079,52420,23993,2.184803901
3125,LP6005442-DNA_G09,19,14811,46422,46422,0.31905,32691,13731,2.380817129
3126,LP6005442-DNA_G09,2,86364,221970,221970,0.38908,150813,71157,2.119440111
3127,LP6005442-DNA_G09,20,21295,57312,57312,0.37156,40101,17211,2.329963396
3128,LP6005442-DNA_G09,21,14207,35893,35893,0.39582,24596,11297,2.17721519
3129,LP6005442-DNA_G09,22,10639,30021,30021,0.35439,21266,8755,2.429011993
3130,LP6005442-DNA_G09,3,71558,190660,190660,0.37532,129245,61415,2.104453309
3131,LP6005442-DNA_G09,4,77853,197557,197557,0.39408,133729,63828,2.095146331
3132,LP6005442-DNA_G09,5,61010,162947,162947,0.37442,110167,52780,2.087286851
3133,LP6005442-DNA_G09,6,62468,172934,172934,0.36122,118313,54621,2.166071657
3134,LP6005442-DNA_G09,7,53074,145897,145897,0.36378,99246,46651,2.127414203
3135,LP6005442-DNA_G09,8,55014,148595,148595,0.37023,98470,50125,1.964488778
3136,LP6005442-DNA_G09,9,41064,112051,112051,0.36648,75098,36953,2.032257192
3137,LP6005442-DNA_G09,MT,30,32,32,0.9375,NA,NA,NA
3138,LP6005442-DNA_G09,X,50356,51092,51092,0.98559,34292,16800,2.041190476
3139,LP6005442-DNA_G09,Y,567,593,593,0.95616,351,242,1.450413223
3140,LP6005442-DNA_G10,1,81236,236397,236397,0.34364,163232,73165,2.231012096
3141,LP6005442-DNA_G10,10,51851,154473,154473,0.33566,106059,48414,2.190667989
3142,LP6005442-DNA_G10,11,51825,151685,151685,0.34166,103211,48474,2.129203284
3143,LP6005442-DNA_G10,12,48373,143899,143899,0.33616,98752,45147,2.187343567
3144,LP6005442-DNA_G10,13,40345,116301,116301,0.3469,79093,37208,2.125698774
3145,LP6005442-DNA_G10,14,36027,101706,101706,0.35423,69717,31989,2.179405421
3146,LP6005442-DNA_G10,15,30759,88906,88906,0.34597,60451,28455,2.124442102
3147,LP6005442-DNA_G10,16,31923,93498,93498,0.34143,61478,32020,1.919987508
3148,LP6005442-DNA_G10,17,25256,77630,77630,0.32534,54776,22854,2.396779557
3149,LP6005442-DNA_G10,18,30573,91770,91770,0.33315,62834,28936,2.171481891
3150,LP6005442-DNA_G10,19,19608,57000,57000,0.344,40162,16838,2.385200143
3151,LP6005442-DNA_G10,2,87215,264225,264225,0.33008,179594,84631,2.122082925
3152,LP6005442-DNA_G10,20,23663,68945,68945,0.34322,48192,20753,2.322170289
3153,LP6005442-DNA_G10,21,16302,45765,45765,0.35621,31282,14483,2.159911621
3154,LP6005442-DNA_G10,22,12478,37656,37656,0.33137,26633,11023,2.41612991
3155,LP6005442-DNA_G10,3,77816,229423,229423,0.33918,155075,74348,2.085799215
3156,LP6005442-DNA_G10,4,79131,231909,231909,0.34122,156424,75485,2.072252765
3157,LP6005442-DNA_G10,5,69997,202671,202671,0.34537,136712,65959,2.072681514
3158,LP6005442-DNA_G10,6,68526,200533,200533,0.34172,137553,62980,2.184074309
3159,LP6005442-DNA_G10,7,58571,173816,173816,0.33697,118047,55769,2.116713586
3160,LP6005442-DNA_G10,8,59113,176264,176264,0.33537,116865,59399,1.967457365
3161,LP6005442-DNA_G10,9,41721,130515,130515,0.31966,87352,43163,2.023770359
3162,LP6005442-DNA_G10,MT,31,34,34,0.91176,32,2,16
3163,LP6005442-DNA_G10,X,68615,69671,69671,0.98484,46715,22956,2.034979962
3164,LP6005442-DNA_G10,Y,958,1000,1000,0.958,632,368,1.717391304
3165,LP6005442-DNA_G11,1,81512,241031,241031,0.33818,166538,74493,2.235619454
3166,LP6005442-DNA_G11,10,49997,155685,155685,0.32114,107086,48599,2.203460977
3167,LP6005442-DNA_G11,11,48727,152313,152313,0.31991,103675,48638,2.131563798
3168,LP6005442-DNA_G11,12,48499,145355,145355,0.33366,99963,45392,2.20221625
3169,LP6005442-DNA_G11,13,37710,116012,116012,0.32505,78880,37132,2.124313261
3170,LP6005442-DNA_G11,14,34655,102823,102823,0.33704,70516,32307,2.182684867
3171,LP6005442-DNA_G11,15,30160,92602,92602,0.32569,63168,29434,2.146089556
3172,LP6005442-DNA_G11,16,33010,94944,94944,0.34768,62392,32552,1.916687147
3173,LP6005442-DNA_G11,17,26793,78709,78709,0.34041,55652,23057,2.413670469
3174,LP6005442-DNA_G11,18,29596,92070,92070,0.32145,62931,29139,2.159682899
3175,LP6005442-DNA_G11,19,20050,57215,57215,0.35043,40434,16781,2.409510756
3176,LP6005442-DNA_G11,2,92369,266449,266449,0.34667,181004,85445,2.118368541
3177,LP6005442-DNA_G11,20,23353,72250,72250,0.32322,50440,21810,2.312700596
3178,LP6005442-DNA_G11,21,16840,46796,46796,0.35986,32053,14743,2.17411653
3179,LP6005442-DNA_G11,22,13488,38816,38816,0.34749,27518,11298,2.435652328
3180,LP6005442-DNA_G11,3,79519,230433,230433,0.34509,156158,74275,2.102430158
3181,LP6005442-DNA_G11,4,77138,233903,233903,0.32979,158275,75628,2.092809541
3182,LP6005442-DNA_G11,5,68289,207926,207926,0.32843,140524,67402,2.084863951
3183,LP6005442-DNA_G11,6,68148,205021,205021,0.3324,140411,64610,2.173208482
3184,LP6005442-DNA_G11,7,61646,181267,181267,0.34008,123138,58129,2.118357446
3185,LP6005442-DNA_G11,8,59353,178030,178030,0.33339,118117,59913,1.971475306
3186,LP6005442-DNA_G11,9,42183,132532,132532,0.31829,88664,43868,2.021154372
3187,LP6005442-DNA_G11,MT,59,61,61,0.96721,60,1,60
3188,LP6005442-DNA_G11,X,72489,73677,73677,0.98388,49506,24171,2.048156882
3189,LP6005442-DNA_G11,Y,942,996,996,0.94578,627,369,1.699186992
3190,LP6005442-DNA_G12,1,88058,196578,196578,0.44795,135556,61022,2.221428337
3191,LP6005442-DNA_G12,10,56863,128544,128544,0.44236,88621,39923,2.219798111
3192,LP6005442-DNA_G12,11,56593,128965,128965,0.43882,87553,41412,2.114193953
3193,LP6005442-DNA_G12,12,52313,121653,121653,0.43002,83582,38071,2.195424339
3194,LP6005442-DNA_G12,13,48985,101607,101607,0.4821,69253,32354,2.140477221
3195,LP6005442-DNA_G12,14,33456,82912,82912,0.40351,56530,26382,2.142748844
3196,LP6005442-DNA_G12,15,31149,74797,74797,0.41645,50869,23928,2.125919425
3197,LP6005442-DNA_G12,16,33239,74658,74658,0.44522,48802,25856,1.887453589
3198,LP6005442-DNA_G12,17,25882,60018,60018,0.43124,42275,17743,2.382629769
3199,LP6005442-DNA_G12,18,35462,77803,77803,0.45579,53355,24448,2.182387107
3200,LP6005442-DNA_G12,19,16429,44212,44212,0.3716,31202,13010,2.398308993
3201,LP6005442-DNA_G12,2,97734,211647,211647,0.46178,143568,68079,2.108844137
3202,LP6005442-DNA_G12,20,23422,53506,53506,0.43775,37439,16067,2.330179872
3203,LP6005442-DNA_G12,21,14198,35340,35340,0.40175,24084,11256,2.139658849
3204,LP6005442-DNA_G12,22,12487,27783,27783,0.44945,19589,8194,2.390651696
3205,LP6005442-DNA_G12,3,78067,188081,188081,0.41507,126996,61085,2.079004666
3206,LP6005442-DNA_G12,4,90280,198261,198261,0.45536,133897,64364,2.080308868
3207,LP6005442-DNA_G12,5,64304,157978,157978,0.40704,106551,51427,2.071888308
3208,LP6005442-DNA_G12,6,71803,169196,169196,0.42438,115746,53450,2.165500468
3209,LP6005442-DNA_G12,7,61466,140061,140061,0.43885,95513,44548,2.144046871
3210,LP6005442-DNA_G12,8,58674,144264,144264,0.40671,95446,48818,1.955139498
3211,LP6005442-DNA_G12,9,46097,106270,106270,0.43377,71253,35017,2.034811663
3212,LP6005442-DNA_G12,MT,39,41,41,0.95122,38,3,12.66666667
3213,LP6005442-DNA_G12,X,34981,71621,71621,0.48842,48316,23305,2.073203175
3214,LP6005442-DNA_H01,1,81415,191074,191074,0.42609,131511,59563,2.207931098
3215,LP6005442-DNA_H01,10,52451,121614,121614,0.43129,83571,38043,2.196751045
3216,LP6005442-DNA_H01,11,52020,119576,119576,0.43504,80896,38680,2.091416753
3217,LP6005442-DNA_H01,12,48036,117842,117842,0.40763,80996,36846,2.198230473
3218,LP6005442-DNA_H01,13,45375,96908,96908,0.46823,66052,30856,2.140653358
3219,LP6005442-DNA_H01,14,34186,79978,79978,0.42744,54549,25429,2.145149239
3220,LP6005442-DNA_H01,15,30048,70957,70957,0.42347,48400,22557,2.1456754
3221,LP6005442-DNA_H01,16,30029,71761,71761,0.41846,46964,24797,1.893938783
3222,LP6005442-DNA_H01,17,23095,54922,54922,0.42051,38625,16297,2.370068111
3223,LP6005442-DNA_H01,18,32335,75338,75338,0.4292,51651,23687,2.180563178
3224,LP6005442-DNA_H01,19,14142,38096,38096,0.37122,26726,11370,2.35057168
3225,LP6005442-DNA_H01,2,93392,205134,205134,0.45527,139120,66014,2.107431757
3226,LP6005442-DNA_H01,20,20029,51302,51302,0.39041,35669,15633,2.281647796
3227,LP6005442-DNA_H01,21,13709,34231,34231,0.40048,23336,10895,2.141899954
3228,LP6005442-DNA_H01,22,10738,27480,27480,0.39076,19441,8039,2.418335614
3229,LP6005442-DNA_H01,3,77022,179514,179514,0.42906,121314,58200,2.08443299
3230,LP6005442-DNA_H01,4,80452,186181,186181,0.43212,125543,60638,2.070368416
3231,LP6005442-DNA_H01,5,59395,152229,152229,0.39017,102531,49698,2.063081009
3232,LP6005442-DNA_H01,6,69252,160862,160862,0.43051,110133,50729,2.171006722
3233,LP6005442-DNA_H01,7,56462,131752,131752,0.42855,89579,42173,2.12408413
3234,LP6005442-DNA_H01,8,54253,127823,127823,0.42444,84810,43013,1.971729477
3235,LP6005442-DNA_H01,9,43129,102542,102542,0.4206,68386,34156,2.00216653
3236,LP6005442-DNA_H01,MT,29,35,35,0.82857,31,4,7.75
3237,LP6005442-DNA_H01,X,31009,67936,67936,0.45644,45847,22089,2.07555797
3238,LP6005442-DNA_H03,1,78954,193461,193461,0.40811,133264,60197,2.21379803
3239,LP6005442-DNA_H03,10,48149,127287,127287,0.37827,87497,39790,2.19896959
3240,LP6005442-DNA_H03,11,52594,127505,127505,0.41249,86581,40924,2.115653406
3241,LP6005442-DNA_H03,12,44881,118669,118669,0.3782,81780,36889,2.216921033
3242,LP6005442-DNA_H03,13,42414,99408,99408,0.42667,67781,31627,2.143137193
3243,LP6005442-DNA_H03,14,31975,80419,80419,0.39761,54928,25491,2.154799733
3244,LP6005442-DNA_H03,15,29807,73688,73688,0.4045,50342,23346,2.156343699
3245,LP6005442-DNA_H03,16,27762,73030,73030,0.38015,47915,25115,1.90782401
3246,LP6005442-DNA_H03,17,22445,58583,58583,0.38313,41390,17193,2.407375095
3247,LP6005442-DNA_H03,18,31259,76642,76642,0.40786,52366,24276,2.157109903
3248,LP6005442-DNA_H03,19,15427,42949,42949,0.35919,30359,12590,2.411358221
3249,LP6005442-DNA_H03,2,84068,210924,210924,0.39857,143820,67104,2.143240343
3250,LP6005442-DNA_H03,20,18015,52116,52116,0.34567,36259,15857,2.286624204
3251,LP6005442-DNA_H03,21,12720,35507,35507,0.35824,24158,11349,2.128645696
3252,LP6005442-DNA_H03,22,9411,28152,28152,0.33429,19941,8211,2.428571429
3253,LP6005442-DNA_H03,3,67006,181732,181732,0.36871,122945,58787,2.091363737
3254,LP6005442-DNA_H03,4,78976,190616,190616,0.41432,128806,61810,2.083902281
3255,LP6005442-DNA_H03,5,58752,163180,163180,0.36004,110128,53052,2.075850109
3256,LP6005442-DNA_H03,6,61799,159061,159061,0.38852,108882,50179,2.169871859
3257,LP6005442-DNA_H03,7,53029,139489,139489,0.38017,94877,44612,2.126714785
3258,LP6005442-DNA_H03,8,50662,134917,134917,0.3755,89387,45530,1.963254997
3259,LP6005442-DNA_H03,9,41664,102760,102760,0.40545,68723,34037,2.019067485
3260,LP6005442-DNA_H03,MT,35,35,35,1,NA,NA,NA
3261,LP6005442-DNA_H03,X,49634,50259,50259,0.98756,33799,16460,2.053402187
3262,LP6005442-DNA_H03,Y,692,726,726,0.95317,450,276,1.630434783
3263,LP6005442-DNA_H04,1,78996,200497,200497,0.394,138157,62340,2.216185435
3264,LP6005442-DNA_H04,10,51410,132069,132069,0.38927,90743,41326,2.195784736
3265,LP6005442-DNA_H04,11,55470,126526,126526,0.43841,85952,40574,2.118400946
3266,LP6005442-DNA_H04,12,50636,122051,122051,0.41488,84039,38012,2.210854467
3267,LP6005442-DNA_H04,13,44013,104874,104874,0.41968,71386,33488,2.131688963
3268,LP6005442-DNA_H04,14,35337,87006,87006,0.40614,59468,27538,2.159488707
3269,LP6005442-DNA_H04,15,28419,75294,75294,0.37744,51282,24012,2.135682159
3270,LP6005442-DNA_H04,16,28884,75647,75647,0.38183,49755,25892,1.921636027
3271,LP6005442-DNA_H04,17,23370,61426,61426,0.38046,43407,18019,2.408957212
3272,LP6005442-DNA_H04,18,31365,76912,76912,0.4078,52824,24088,2.19295915
3273,LP6005442-DNA_H04,19,16231,45830,45830,0.35416,32379,13451,2.407181622
3274,LP6005442-DNA_H04,2,87294,213992,213992,0.40793,145677,68315,2.132430652
3275,LP6005442-DNA_H04,20,18276,53928,53928,0.3389,37515,16413,2.285688174
3276,LP6005442-DNA_H04,21,14088,36469,36469,0.3863,24909,11560,2.154757785
3277,LP6005442-DNA_H04,22,10698,29763,29763,0.35944,21135,8628,2.449582754
3278,LP6005442-DNA_H04,3,71199,189429,189429,0.37586,128055,61374,2.086469841
3279,LP6005442-DNA_H04,4,80770,197579,197579,0.4088,133783,63796,2.097043702
3280,LP6005442-DNA_H04,5,59885,163196,163196,0.36695,110394,52802,2.090716261
3281,LP6005442-DNA_H04,6,59421,165232,165232,0.35962,113091,52141,2.168945743
3282,LP6005442-DNA_H04,7,52298,147909,147909,0.35358,100701,47208,2.133134215
3283,LP6005442-DNA_H04,8,53817,142919,142919,0.37656,94569,48350,1.955925543
3284,LP6005442-DNA_H04,9,42453,108775,108775,0.39028,72941,35834,2.03552492
3285,LP6005442-DNA_H04,MT,34,36,36,0.94444,34,2,17
3286,LP6005442-DNA_H04,X,52006,52935,52935,0.98245,35684,17251,2.068517767
3287,LP6005442-DNA_H04,Y,116,142,142,0.8169,85,57,1.49122807
3288,LP6005442-DNA_H09,1,80833,202795,202795,0.39859,139759,63036,2.217129894
3289,LP6005442-DNA_H09,10,51748,130172,130172,0.39754,89793,40379,2.223754922
3290,LP6005442-DNA_H09,11,53943,130859,130859,0.41222,88902,41957,2.118883619
3291,LP6005442-DNA_H09,12,49201,122338,122338,0.40217,84156,38182,2.204075219
3292,LP6005442-DNA_H09,13,45013,105177,105177,0.42797,71727,33450,2.144304933
3293,LP6005442-DNA_H09,14,31773,84776,84776,0.37479,57860,26916,2.149650765
3294,LP6005442-DNA_H09,15,28035,76107,76107,0.36836,51728,24379,2.121826162
3295,LP6005442-DNA_H09,16,30052,78922,78922,0.38078,51721,27201,1.901437447
3296,LP6005442-DNA_H09,17,23946,63155,63155,0.37916,44569,18586,2.397987733
3297,LP6005442-DNA_H09,18,30591,78212,78212,0.39113,53531,24681,2.16891536
3298,LP6005442-DNA_H09,19,16441,46682,46682,0.35219,32749,13933,2.35046293
3299,LP6005442-DNA_H09,2,86684,221840,221840,0.39075,150657,71183,2.116474439
3300,LP6005442-DNA_H09,20,20093,57138,57138,0.35166,39831,17307,2.301438724
3301,LP6005442-DNA_H09,21,12933,36690,36690,0.35249,25044,11646,2.150437919
3302,LP6005442-DNA_H09,22,10674,29801,29801,0.35818,21196,8605,2.463219059
3303,LP6005442-DNA_H09,3,71705,192924,192924,0.37167,130433,62491,2.087228561
3304,LP6005442-DNA_H09,4,78560,196987,196987,0.39881,132836,64151,2.070676996
3305,LP6005442-DNA_H09,5,59272,165931,165931,0.35721,112067,53864,2.08055473
3306,LP6005442-DNA_H09,6,64885,171070,171070,0.37929,117099,53971,2.169665191
3307,LP6005442-DNA_H09,7,62098,138464,138464,0.44848,94154,44310,2.124892801
3308,LP6005442-DNA_H09,8,52901,142751,142751,0.37058,94504,48247,1.958753912
3309,LP6005442-DNA_H09,9,42025,111527,111527,0.37681,74693,36834,2.027827551
3310,LP6005442-DNA_H09,MT,46,51,51,0.90196,45,6,7.5
3311,LP6005442-DNA_H09,X,30849,77244,77244,0.39937,52259,24985,2.091614969
3312,LP6005442-DNA_H10,1,78394,235466,235466,0.33293,162596,72870,2.231316042
3313,LP6005442-DNA_H10,10,48921,148918,148918,0.32851,102502,46416,2.208333333
3314,LP6005442-DNA_H10,11,46988,147609,147609,0.31833,100399,47210,2.126646897
3315,LP6005442-DNA_H10,12,45144,138933,138933,0.32493,95454,43479,2.195404678
3316,LP6005442-DNA_H10,13,36996,112566,112566,0.32866,76854,35712,2.152049731
3317,LP6005442-DNA_H10,14,31856,97136,97136,0.32795,66514,30622,2.172098491
3318,LP6005442-DNA_H10,15,26837,87734,87734,0.30589,59685,28049,2.127883347
3319,LP6005442-DNA_H10,16,30698,91443,91443,0.33571,60070,31373,1.914703726
3320,LP6005442-DNA_H10,17,24929,76367,76367,0.32644,53852,22515,2.39182767
3321,LP6005442-DNA_H10,18,28351,86881,86881,0.32632,59532,27349,2.176752349
3322,LP6005442-DNA_H10,19,19293,56978,56978,0.3386,40116,16862,2.379077215
3323,LP6005442-DNA_H10,2,86772,254509,254509,0.34094,173125,81384,2.127260887
3324,LP6005442-DNA_H10,20,21515,66599,66599,0.32305,46584,20015,2.327454409
3325,LP6005442-DNA_H10,21,15247,45497,45497,0.33512,31043,14454,2.147709976
3326,LP6005442-DNA_H10,22,12728,36944,36944,0.34452,26150,10794,2.422642209
3327,LP6005442-DNA_H10,3,75149,221519,221519,0.33924,149835,71684,2.09021539
3328,LP6005442-DNA_H10,4,73903,222119,222119,0.33272,149906,72213,2.075886613
3329,LP6005442-DNA_H10,5,62751,196127,196127,0.31995,132658,63469,2.090122737
3330,LP6005442-DNA_H10,6,67514,194097,194097,0.34784,133072,61025,2.180614502
3331,LP6005442-DNA_H10,7,58011,170119,170119,0.341,115507,54612,2.115047975
3332,LP6005442-DNA_H10,8,58534,173259,173259,0.33784,114940,58319,1.970884274
3333,LP6005442-DNA_H10,9,43533,129256,129256,0.3368,86366,42890,2.013662858
3334,LP6005442-DNA_H10,MT,34,38,38,0.89474,37,1,37
3335,LP6005442-DNA_H10,X,34070,102779,102779,0.33149,69242,33537,2.064645019
3336,LP6005442-DNA_H11,1,79288,239489,239489,0.33107,165546,73943,2.238832614
3337,LP6005442-DNA_H11,10,51139,154245,154245,0.33154,106224,48021,2.212032236
3338,LP6005442-DNA_H11,11,51566,153602,153602,0.33571,104795,48807,2.147130535
3339,LP6005442-DNA_H11,12,49962,147268,147268,0.33926,101333,45935,2.20600849
3340,LP6005442-DNA_H11,13,37821,116864,116864,0.32363,79621,37243,2.137878259
3341,LP6005442-DNA_H11,14,34806,104089,104089,0.33439,71380,32709,2.182273992
3342,LP6005442-DNA_H11,15,31452,93625,93625,0.33594,63698,29927,2.128445885
3343,LP6005442-DNA_H11,16,32777,96207,96207,0.34069,63254,32953,1.919521743
3344,LP6005442-DNA_H11,17,26605,80146,80146,0.33196,56496,23650,2.388837209
3345,LP6005442-DNA_H11,18,28969,89710,89710,0.32292,61441,28269,2.173440872
3346,LP6005442-DNA_H11,19,20726,61293,61293,0.33815,43106,18187,2.370154506
3347,LP6005442-DNA_H11,2,90172,268207,268207,0.3362,181998,86209,2.111125289
3348,LP6005442-DNA_H11,20,22763,72058,72058,0.3159,50349,21709,2.319268506
3349,LP6005442-DNA_H11,21,16388,47090,47090,0.34801,32223,14867,2.167417771
3350,LP6005442-DNA_H11,22,12853,39829,39829,0.3227,28150,11679,2.410309102
3351,LP6005442-DNA_H11,3,78297,231140,231140,0.33874,156592,74548,2.100552664
3352,LP6005442-DNA_H11,4,79246,232307,232307,0.34113,157054,75253,2.087013142
3353,LP6005442-DNA_H11,5,68817,206076,206076,0.33394,139472,66604,2.094048406
3354,LP6005442-DNA_H11,6,66617,204363,204363,0.32597,140318,64045,2.190928254
3355,LP6005442-DNA_H11,7,61079,180734,180734,0.33795,122764,57970,2.11771606
3356,LP6005442-DNA_H11,8,59678,182659,182659,0.32672,121245,61414,1.974224118
3357,LP6005442-DNA_H11,9,43979,134491,134491,0.327,90097,44394,2.029485967
3358,LP6005442-DNA_H11,MT,52,56,56,0.92857,NA,NA,NA
3359,LP6005442-DNA_H11,X,36756,110828,110828,0.33165,74652,36176,2.063578063
3360,LP6005442-DNA_H12,1,92324,194068,194068,0.47573,133796,60272,2.219869923
3361,LP6005442-DNA_H12,10,58431,128918,128918,0.45324,88759,40159,2.210189497
3362,LP6005442-DNA_H12,11,58537,126818,126818,0.46158,85936,40882,2.102049802
3363,LP6005442-DNA_H12,12,54120,119263,119263,0.45379,82041,37222,2.204099726
3364,LP6005442-DNA_H12,13,47662,104437,104437,0.45637,71244,33193,2.146356159
3365,LP6005442-DNA_H12,14,35816,82467,82467,0.43431,56337,26130,2.156027555
3366,LP6005442-DNA_H12,15,31741,73728,73728,0.43051,50168,23560,2.129371817
3367,LP6005442-DNA_H12,16,31206,75234,75234,0.41479,49254,25980,1.895842956
3368,LP6005442-DNA_H12,17,26039,59282,59282,0.43924,41738,17544,2.379046968
3369,LP6005442-DNA_H12,18,34841,77395,77395,0.45017,52912,24483,2.161173059
3370,LP6005442-DNA_H12,19,17273,45062,45062,0.38332,31767,13295,2.389394509
3371,LP6005442-DNA_H12,2,98554,217159,217159,0.45383,147693,69466,2.126119253
3372,LP6005442-DNA_H12,20,21707,52859,52859,0.41066,36885,15974,2.30906473
3373,LP6005442-DNA_H12,21,15558,35303,35303,0.4407,24133,11170,2.160519248
3374,LP6005442-DNA_H12,22,13579,28225,28225,0.4811,19899,8326,2.389983185
3375,LP6005442-DNA_H12,3,81965,188846,188846,0.43403,127867,60979,2.096902212
3376,LP6005442-DNA_H12,4,89689,193778,193778,0.46284,130933,62845,2.08342748
3377,LP6005442-DNA_H12,5,64263,159926,159926,0.40183,107822,52104,2.069361277
3378,LP6005442-DNA_H12,6,75054,167573,167573,0.44789,114618,52955,2.164441507
3379,LP6005442-DNA_H12,7,61840,144506,144506,0.42794,98296,46210,2.127158624
3380,LP6005442-DNA_H12,8,58417,140146,140146,0.41683,92915,47231,1.967246088
3381,LP6005442-DNA_H12,9,44587,109773,109773,0.40617,73283,36490,2.008303645
3382,LP6005442-DNA_H12,MT,25,27,27,0.92593,26,1,26
3383,LP6005442-DNA_H12,X,33636,71270,71270,0.47195,48174,23096,2.085815726
3384,LP6005443-DNA_A01,1,77387,234082,234082,0.3306,161934,72148,2.244469701
3385,LP6005443-DNA_A01,10,51120,150681,150681,0.33926,103697,46984,2.207070492
3386,LP6005443-DNA_A01,11,49272,146278,146278,0.33684,99650,46628,2.137127906
3387,LP6005443-DNA_A01,12,46906,141317,141317,0.33192,97260,44057,2.207594707
3388,LP6005443-DNA_A01,13,39125,115292,115292,0.33936,78517,36775,2.135064582
3389,LP6005443-DNA_A01,14,32795,99487,99487,0.32964,68150,31337,2.174745509
3390,LP6005443-DNA_A01,15,28284,89604,89604,0.31566,61001,28603,2.13267839
3391,LP6005443-DNA_A01,16,29978,92386,92386,0.32449,60595,31791,1.906042591
3392,LP6005443-DNA_A01,17,25824,76247,76247,0.33869,53998,22249,2.426985482
3393,LP6005443-DNA_A01,18,29544,90005,90005,0.32825,61658,28347,2.175115533
3394,LP6005443-DNA_A01,19,18254,57741,57741,0.31614,40624,17117,2.373313081
3395,LP6005443-DNA_A01,2,85915,260195,260195,0.33019,176888,83307,2.123326971
3396,LP6005443-DNA_A01,20,22596,68729,68729,0.32877,48024,20705,2.319439749
3397,LP6005443-DNA_A01,21,15315,45786,45786,0.33449,31398,14388,2.182235196
3398,LP6005443-DNA_A01,22,12478,37266,37266,0.33484,26503,10763,2.462417542
3399,LP6005443-DNA_A01,3,73592,222526,222526,0.33071,150309,72217,2.081352036
3400,LP6005443-DNA_A01,4,75231,226380,226380,0.33232,152702,73678,2.072558973
3401,LP6005443-DNA_A01,5,65689,202713,202713,0.32405,136962,65751,2.083040562
3402,LP6005443-DNA_A01,6,67067,198178,198178,0.33842,135950,62228,2.184707849
3403,LP6005443-DNA_A01,7,59382,172557,172557,0.34413,117108,55449,2.111994806
3404,LP6005443-DNA_A01,8,56685,175639,175639,0.32274,116517,59122,1.970789216
3405,LP6005443-DNA_A01,9,40896,129085,129085,0.31681,86410,42675,2.024838899
3406,LP6005443-DNA_A01,MT,29,33,33,0.87879,31,2,15.5
3407,LP6005443-DNA_A01,X,67413,68309,68309,0.98688,46028,22281,2.06579597
3408,LP6005443-DNA_A01,Y,966,998,998,0.96794,642,356,1.803370787
3409,LP6005443-DNA_A02,1,86375,194970,194970,0.44302,134331,60639,2.215257508
3410,LP6005443-DNA_A02,10,55908,126751,126751,0.44109,87353,39398,2.217193766
3411,LP6005443-DNA_A02,11,52893,125336,125336,0.42201,85118,40218,2.116415535
3412,LP6005443-DNA_A02,12,52137,120102,120102,0.43411,82599,37503,2.202463803
3413,LP6005443-DNA_A02,13,47222,102025,102025,0.46285,69455,32570,2.132483881
3414,LP6005443-DNA_A02,14,33988,81874,81874,0.41513,55892,25982,2.151181587
3415,LP6005443-DNA_A02,15,32072,73731,73731,0.43499,50178,23553,2.130429245
3416,LP6005443-DNA_A02,16,32986,71748,71748,0.45975,46913,24835,1.888987316
3417,LP6005443-DNA_A02,17,24598,58663,58663,0.41931,41443,17220,2.406678281
3418,LP6005443-DNA_A02,18,33889,75406,75406,0.44942,51804,23602,2.194898737
3419,LP6005443-DNA_A02,19,14875,40956,40956,0.36319,28850,12106,2.38311581
3420,LP6005443-DNA_A02,2,91107,212671,212671,0.42839,144540,68131,2.121501226
3421,LP6005443-DNA_A02,20,21637,52316,52316,0.41358,36367,15949,2.280205656
3422,LP6005443-DNA_A02,21,15089,33980,33980,0.44406,23156,10824,2.13932003
3423,LP6005443-DNA_A02,22,11201,28472,28472,0.3934,20227,8245,2.453244391
3424,LP6005443-DNA_A02,3,79694,181418,181418,0.43928,122748,58670,2.092176581
3425,LP6005443-DNA_A02,4,84778,194889,194889,0.43501,131982,62907,2.098049502
3426,LP6005443-DNA_A02,5,68725,146649,146649,0.46864,98922,47727,2.072663272
3427,LP6005443-DNA_A02,6,70755,166377,166377,0.42527,114090,52287,2.181995525
3428,LP6005443-DNA_A02,7,56965,140028,140028,0.40681,95393,44635,2.137179344
3429,LP6005443-DNA_A02,8,56019,134144,134144,0.4176,88771,45373,1.956471911
3430,LP6005443-DNA_A02,9,46100,106721,106721,0.43197,71245,35476,2.008259105
3431,LP6005443-DNA_A02,MT,28,31,31,0.90323,28,3,9.333333333
3432,LP6005443-DNA_A02,X,52266,52940,52940,0.98727,35538,17402,2.04217906
3433,LP6005443-DNA_A02,Y,674,694,694,0.97118,437,257,1.700389105
3434,LP6005443-DNA_A03,1,79632,193257,193257,0.41205,132999,60258,2.207159215
3435,LP6005443-DNA_A03,10,52925,127245,127245,0.41593,87323,39922,2.187340314
3436,LP6005443-DNA_A03,11,52249,130583,130583,0.40012,88435,42148,2.098201575
3437,LP6005443-DNA_A03,12,50037,122536,122536,0.40835,84033,38503,2.182505259
3438,LP6005443-DNA_A03,13,46330,106527,106527,0.43491,72394,34133,2.120938681
3439,LP6005443-DNA_A03,14,32425,81577,81577,0.39748,55554,26023,2.134803827
3440,LP6005443-DNA_A03,15,32240,70632,70632,0.45645,47982,22650,2.118410596
3441,LP6005443-DNA_A03,16,27505,73461,73461,0.37442,48202,25259,1.908309909
3442,LP6005443-DNA_A03,17,21702,58296,58296,0.37227,41167,17129,2.403351042
3443,LP6005443-DNA_A03,18,32793,78441,78441,0.41806,53716,24725,2.172537917
3444,LP6005443-DNA_A03,19,13837,40938,40938,0.338,28665,12273,2.335614764
3445,LP6005443-DNA_A03,2,87328,222872,222872,0.39183,151322,71550,2.114912648
3446,LP6005443-DNA_A03,20,18718,53574,53574,0.34939,37212,16362,2.274294096
3447,LP6005443-DNA_A03,21,15173,34773,34773,0.43634,23803,10970,2.1698268
3448,LP6005443-DNA_A03,22,9190,26718,26718,0.34396,18970,7748,2.448373774
3449,LP6005443-DNA_A03,3,72494,190075,190075,0.3814,128371,61704,2.080432387
3450,LP6005443-DNA_A03,4,83641,199999,199999,0.41821,135261,64738,2.08936019
3451,LP6005443-DNA_A03,5,62703,161052,161052,0.38933,108677,52375,2.07497852
3452,LP6005443-DNA_A03,6,65490,169077,169077,0.38734,115864,53213,2.177362675
3453,LP6005443-DNA_A03,7,56547,145689,145689,0.38813,98994,46695,2.120012849
3454,LP6005443-DNA_A03,8,61332,138234,138234,0.44368,91304,46930,1.945535905
3455,LP6005443-DNA_A03,9,43722,108722,108722,0.40214,72474,36248,1.99939307
3456,LP6005443-DNA_A03,MT,37,40,40,0.925,38,2,19
3457,LP6005443-DNA_A03,X,53157,54018,54018,0.98406,36233,17785,2.037278606
3458,LP6005443-DNA_A03,Y,732,739,739,0.99053,453,286,1.583916084
3459,LP6005443-DNA_A06,1,75182,197109,197109,0.38142,135993,61116,2.225161987
3460,LP6005443-DNA_A06,10,51419,128199,128199,0.40109,88359,39840,2.217846386
3461,LP6005443-DNA_A06,11,53144,129484,129484,0.41043,88019,41465,2.122730013
3462,LP6005443-DNA_A06,12,47996,130463,130463,0.36789,89718,40745,2.201938888
3463,LP6005443-DNA_A06,13,43113,103201,103201,0.41776,70421,32780,2.148291641
3464,LP6005443-DNA_A06,14,34606,82810,82810,0.4179,56583,26227,2.15743318
3465,LP6005443-DNA_A06,15,30536,74111,74111,0.41203,50584,23527,2.150040379
3466,LP6005443-DNA_A06,16,28882,73883,73883,0.39092,48478,25405,1.908207046
3467,LP6005443-DNA_A06,17,24083,60663,60663,0.397,42855,17808,2.406502695
3468,LP6005443-DNA_A06,18,31413,77126,77126,0.40729,53036,24090,2.201577418
3469,LP6005443-DNA_A06,19,16441,43670,43670,0.37648,30659,13011,2.356390746
3470,LP6005443-DNA_A06,2,83022,214827,214827,0.38646,146173,68654,2.129125761
3471,LP6005443-DNA_A06,20,19907,54884,54884,0.36271,38330,16554,2.315452459
3472,LP6005443-DNA_A06,21,12830,37502,37502,0.34212,25611,11891,2.153813809
3473,LP6005443-DNA_A06,22,10486,29295,29295,0.35795,20759,8536,2.431935333
3474,LP6005443-DNA_A06,3,67295,188527,188527,0.35695,127696,60831,2.099192846
3475,LP6005443-DNA_A06,4,80043,192887,192887,0.41497,130499,62388,2.091732384
3476,LP6005443-DNA_A06,5,60660,163251,163251,0.37158,110339,52912,2.08533036
3477,LP6005443-DNA_A06,6,62925,167285,167285,0.37615,114739,52546,2.18359152
3478,LP6005443-DNA_A06,7,51829,140479,140479,0.36894,95714,44765,2.138143639
3479,LP6005443-DNA_A06,8,51524,142234,142234,0.36225,94338,47896,1.969642559
3480,LP6005443-DNA_A06,9,41957,106602,106602,0.39359,71203,35399,2.011441001
3481,LP6005443-DNA_A06,MT,12,17,17,0.70588,13,4,3.25
3482,LP6005443-DNA_A06,X,50579,51333,51333,0.98531,34498,16835,2.049183249
3483,LP6005443-DNA_A06,Y,710,740,740,0.95946,463,277,1.671480144
3484,LP6005443-DNA_A07,1,82266,196560,196560,0.41853,135469,61091,2.217495212
3485,LP6005443-DNA_A07,10,53793,126805,126805,0.42422,86981,39824,2.184135195
3486,LP6005443-DNA_A07,11,52158,128610,128610,0.40555,86982,41628,2.089507063
3487,LP6005443-DNA_A07,12,49884,119387,119387,0.41783,81997,37390,2.193019524
3488,LP6005443-DNA_A07,13,45301,100146,100146,0.45235,68265,31881,2.141244001
3489,LP6005443-DNA_A07,14,32691,83195,83195,0.39294,56704,26491,2.140500547
3490,LP6005443-DNA_A07,15,29137,73505,73505,0.39639,50071,23434,2.136681744
3491,LP6005443-DNA_A07,16,28524,72216,72216,0.39498,47309,24907,1.899425864
3492,LP6005443-DNA_A07,17,23988,61430,61430,0.39049,43319,18111,2.3918613
3493,LP6005443-DNA_A07,18,32704,77498,77498,0.422,53077,24421,2.173416322
3494,LP6005443-DNA_A07,19,15290,40952,40952,0.37336,28787,12165,2.366378956
3495,LP6005443-DNA_A07,2,92138,214618,214618,0.42931,145729,68889,2.115417556
3496,LP6005443-DNA_A07,20,21767,53200,53200,0.40915,37050,16150,2.294117647
3497,LP6005443-DNA_A07,21,14077,34793,34793,0.40459,23557,11236,2.096564614
3498,LP6005443-DNA_A07,22,10714,26921,26921,0.39798,19129,7792,2.454953799
3499,LP6005443-DNA_A07,3,76324,184762,184762,0.41309,124839,59923,2.083323599
3500,LP6005443-DNA_A07,4,82959,197738,197738,0.41954,133681,64057,2.086906973
3501,LP6005443-DNA_A07,5,59553,153875,153875,0.38702,103894,49981,2.078669895
3502,LP6005443-DNA_A07,6,67857,167245,167245,0.40573,114753,52492,2.186104549
3503,LP6005443-DNA_A07,7,53479,142419,142419,0.3755,96841,45578,2.12473123
3504,LP6005443-DNA_A07,8,53766,137322,137322,0.39153,90972,46350,1.962718447
3505,LP6005443-DNA_A07,9,43377,107871,107871,0.40212,72053,35818,2.011642191
3506,LP6005443-DNA_A07,MT,39,42,42,0.92857,40,2,20
3507,LP6005443-DNA_A07,X,50339,51184,51184,0.98349,34549,16635,2.076886084
3508,LP6005443-DNA_A07,Y,613,655,655,0.93588,432,223,1.937219731
3509,LP6005443-DNA_A08,1,97335,194386,194386,0.50073,134131,60255,2.226055929
3510,LP6005443-DNA_A08,10,60827,126236,126236,0.48185,86842,39394,2.204447378
3511,LP6005443-DNA_A08,11,65051,120080,120080,0.54173,81405,38675,2.104848093
3512,LP6005443-DNA_A08,12,61780,122747,122747,0.50331,84415,38332,2.202207033
3513,LP6005443-DNA_A08,13,53927,96333,96333,0.5598,65594,30739,2.133901558
3514,LP6005443-DNA_A08,14,43043,82322,82322,0.52286,56341,25981,2.168546245
3515,LP6005443-DNA_A08,15,34938,73846,73846,0.47312,50133,23713,2.114156792
3516,LP6005443-DNA_A08,16,37780,73668,73668,0.51284,48577,25091,1.93603284
3517,LP6005443-DNA_A08,17,29207,61100,61100,0.47802,43011,18089,2.37774338
3518,LP6005443-DNA_A08,18,38862,74252,74252,0.52338,50871,23381,2.175740986
3519,LP6005443-DNA_A08,19,22355,45991,45991,0.48607,32365,13626,2.375238515
3520,LP6005443-DNA_A08,2,108567,205883,205883,0.52732,139735,66148,2.112459938
3521,LP6005443-DNA_A08,20,25173,55594,55594,0.4528,38686,16908,2.288029335
3522,LP6005443-DNA_A08,21,17121,37052,37052,0.46208,25248,11804,2.138935954
3523,LP6005443-DNA_A08,22,14597,29693,29693,0.4916,21062,8631,2.440273433
3524,LP6005443-DNA_A08,3,93997,188351,188351,0.49905,127291,61060,2.084687193
3525,LP6005443-DNA_A08,4,91261,189661,189661,0.48118,128204,61457,2.086076444
3526,LP6005443-DNA_A08,5,70510,158736,158736,0.4442,107158,51578,2.077591221
3527,LP6005443-DNA_A08,6,83618,163331,163331,0.51195,112014,51317,2.182785432
3528,LP6005443-DNA_A08,7,62745,138646,138646,0.45256,94430,44216,2.135652253
3529,LP6005443-DNA_A08,8,69321,136180,136180,0.50904,90518,45662,1.982348561
3530,LP6005443-DNA_A08,9,50674,107557,107557,0.47114,71986,35571,2.023727194
3531,LP6005443-DNA_A08,MT,47,49,49,0.95918,47,2,23.5
3532,LP6005443-DNA_A08,X,55356,56051,56051,0.9876,37729,18322,2.059218426
3533,LP6005443-DNA_A08,Y,682,715,715,0.95385,454,261,1.739463602
3534,LP6005443-DNA_A12,1,92035,190526,190526,0.48306,131414,59112,2.223135742
3535,LP6005443-DNA_A12,10,58609,124100,124100,0.47227,85207,38893,2.190805543
3536,LP6005443-DNA_A12,11,56461,125763,125763,0.44895,85324,40439,2.109943371
3537,LP6005443-DNA_A12,12,52924,119048,119048,0.44456,81908,37140,2.20538503
3538,LP6005443-DNA_A12,13,48614,98277,98277,0.49466,66884,31393,2.130538655
3539,LP6005443-DNA_A12,14,36835,79503,79503,0.46332,54343,25160,2.159896661
3540,LP6005443-DNA_A12,15,33508,72901,72901,0.45964,49748,23153,2.14866324
3541,LP6005443-DNA_A12,16,32720,70704,70704,0.46277,46450,24254,1.915148017
3542,LP6005443-DNA_A12,17,28340,56576,56576,0.50092,39906,16670,2.393881224
3543,LP6005443-DNA_A12,18,35438,73367,73367,0.48302,50246,23121,2.173175901
3544,LP6005443-DNA_A12,19,16867,42709,42709,0.39493,30044,12665,2.372206869
3545,LP6005443-DNA_A12,2,94894,212283,212283,0.44702,144333,67950,2.12410596
3546,LP6005443-DNA_A12,20,22525,51399,51399,0.43824,35744,15655,2.283232194
3547,LP6005443-DNA_A12,21,15011,33652,33652,0.44607,23002,10650,2.159812207
3548,LP6005443-DNA_A12,22,12574,27021,27021,0.46534,19077,7944,2.401435045
3549,LP6005443-DNA_A12,3,85103,178041,178041,0.478,120395,57646,2.088523055
3550,LP6005443-DNA_A12,4,88020,184376,184376,0.47739,124550,59826,2.081870759
3551,LP6005443-DNA_A12,5,70872,152048,152048,0.46612,102490,49558,2.068081843
3552,LP6005443-DNA_A12,6,74303,159000,159000,0.46731,108627,50373,2.156452862
3553,LP6005443-DNA_A12,7,60115,137304,137304,0.43782,93449,43855,2.130863071
3554,LP6005443-DNA_A12,8,61258,133006,133006,0.46057,88080,44926,1.960557361
3555,LP6005443-DNA_A12,9,46696,104232,104232,0.448,69777,34455,2.025163256
3556,LP6005443-DNA_A12,MT,38,40,40,0.95,38,2,19
3557,LP6005443-DNA_A12,X,53231,53767,53767,0.99003,36242,17525,2.068017118
3558,LP6005443-DNA_A12,Y,520,530,530,0.98113,327,203,1.610837438
3559,LP6005443-DNA_B01,1,90162,198239,198239,0.45481,136514,61725,2.211648441
3560,LP6005443-DNA_B01,10,57170,126666,126666,0.45134,87067,39599,2.198717139
3561,LP6005443-DNA_B01,11,58427,124778,124778,0.46825,84681,40097,2.111903634
3562,LP6005443-DNA_B01,12,53395,122467,122467,0.436,84010,38457,2.184517773
3563,LP6005443-DNA_B01,13,47037,101271,101271,0.46447,68994,32277,2.137559253
3564,LP6005443-DNA_B01,14,36110,83395,83395,0.433,56966,26429,2.155435317
3565,LP6005443-DNA_B01,15,32349,73271,73271,0.4415,49873,23398,2.131506966
3566,LP6005443-DNA_B01,16,30013,72210,72210,0.41563,47339,24871,1.903381448
3567,LP6005443-DNA_B01,17,25995,60119,60119,0.43239,42492,17627,2.410620071
3568,LP6005443-DNA_B01,18,34847,78039,78039,0.44653,53518,24521,2.182537417
3569,LP6005443-DNA_B01,19,15177,42082,42082,0.36065,29529,12553,2.352346053
3570,LP6005443-DNA_B01,2,96832,215690,215690,0.44894,146520,69170,2.118259361
3571,LP6005443-DNA_B01,20,22322,54340,54340,0.41078,37899,16441,2.305151755
3572,LP6005443-DNA_B01,21,14938,35978,35978,0.4152,24533,11445,2.143556138
3573,LP6005443-DNA_B01,22,10376,27913,27913,0.37173,19700,8213,2.398636308
3574,LP6005443-DNA_B01,3,78851,192948,192948,0.40866,130375,62573,2.083566394
3575,LP6005443-DNA_B01,4,85241,192164,192164,0.44358,129690,62474,2.075903576
3576,LP6005443-DNA_B01,5,64391,156271,156271,0.41205,105483,50788,2.076927621
3577,LP6005443-DNA_B01,6,72483,169149,169149,0.42852,115900,53249,2.176566696
3578,LP6005443-DNA_B01,7,59247,141813,141813,0.41778,96322,45491,2.117385857
3579,LP6005443-DNA_B01,8,57356,135984,135984,0.42178,89907,46077,1.951233804
3580,LP6005443-DNA_B01,9,48198,107701,107701,0.44752,71989,35712,2.015821013
3581,LP6005443-DNA_B01,MT,30,33,33,0.90909,31,2,15.5
3582,LP6005443-DNA_B01,X,51569,52672,52672,0.97906,35458,17214,2.059835018
3583,LP6005443-DNA_B01,Y,664,708,708,0.93785,440,268,1.641791045
3584,LP6005443-DNA_B02,1,77846,197955,197955,0.39325,136445,61510,2.218257194
3585,LP6005443-DNA_B02,10,50294,130432,130432,0.3856,89656,40776,2.198744359
3586,LP6005443-DNA_B02,11,52385,128852,128852,0.40655,87347,41505,2.104493435
3587,LP6005443-DNA_B02,12,47846,122356,122356,0.39104,84045,38311,2.193756362
3588,LP6005443-DNA_B02,13,44357,102677,102677,0.43201,69849,32828,2.127726331
3589,LP6005443-DNA_B02,14,32212,82752,82752,0.38926,56476,26276,2.149337799
3590,LP6005443-DNA_B02,15,29783,74073,74073,0.40208,50512,23561,2.143881839
3591,LP6005443-DNA_B02,16,28556,74283,74283,0.38442,48762,25521,1.910661808
3592,LP6005443-DNA_B02,17,21398,60155,60155,0.35571,42382,17773,2.384628369
3593,LP6005443-DNA_B02,18,31527,75250,75250,0.41896,51540,23710,2.173766343
3594,LP6005443-DNA_B02,19,13845,40830,40830,0.33909,28893,11937,2.420457401
3595,LP6005443-DNA_B02,2,84843,217079,217079,0.39084,147251,69828,2.108767257
3596,LP6005443-DNA_B02,20,19127,52998,52998,0.3609,37096,15902,2.332788329
3597,LP6005443-DNA_B02,21,14058,37834,37834,0.37157,25824,12010,2.15020816
3598,LP6005443-DNA_B02,22,9538,27653,27653,0.34492,19570,8083,2.421130768
3599,LP6005443-DNA_B02,3,72151,192266,192266,0.37527,130104,62162,2.092982851
3600,LP6005443-DNA_B02,4,75141,198360,198360,0.37881,134163,64197,2.089864012
3601,LP6005443-DNA_B02,5,57267,163622,163622,0.35,110531,53091,2.081915956
3602,LP6005443-DNA_B02,6,60499,170048,170048,0.35578,116420,53628,2.170880883
3603,LP6005443-DNA_B02,7,50525,142191,142191,0.35533,96651,45540,2.122332016
3604,LP6005443-DNA_B02,8,50665,137988,137988,0.36717,91409,46579,1.96245089
3605,LP6005443-DNA_B02,9,41641,109176,109176,0.38141,73001,36175,2.017995853
3606,LP6005443-DNA_B02,MT,33,36,36,0.91667,34,2,17
3607,LP6005443-DNA_B02,X,50499,51222,51222,0.98588,34523,16699,2.067369304
3608,LP6005443-DNA_B02,Y,372,383,383,0.97128,234,149,1.570469799
3609,LP6005443-DNA_B03,1,87835,189207,189207,0.46423,130251,58956,2.209291675
3610,LP6005443-DNA_B03,10,54207,124847,124847,0.43419,85702,39145,2.189347299
3611,LP6005443-DNA_B03,11,55050,124751,124751,0.44128,84607,40144,2.107587684
3612,LP6005443-DNA_B03,12,55926,117314,117314,0.47672,80499,36815,2.186581556
3613,LP6005443-DNA_B03,13,50744,101542,101542,0.49973,69056,32486,2.125715693
3614,LP6005443-DNA_B03,14,36829,76849,76849,0.47924,52462,24387,2.151228113
3615,LP6005443-DNA_B03,15,32423,71337,71337,0.4545,48567,22770,2.132938076
3616,LP6005443-DNA_B03,16,33301,69797,69797,0.47711,45515,24282,1.874433737
3617,LP6005443-DNA_B03,17,24503,54650,54650,0.44836,38544,16106,2.393145412
3618,LP6005443-DNA_B03,18,34632,75695,75695,0.45752,51787,23908,2.166095031
3619,LP6005443-DNA_B03,19,15285,38526,38526,0.39675,27161,11365,2.389881214
3620,LP6005443-DNA_B03,2,94490,215041,215041,0.4394,145859,69182,2.108337429
3621,LP6005443-DNA_B03,20,22119,51165,51165,0.43231,35621,15544,2.291623778
3622,LP6005443-DNA_B03,21,14320,35208,35208,0.40673,24120,11088,2.175324675
3623,LP6005443-DNA_B03,22,10216,27559,27559,0.3707,19551,8008,2.441433566
3624,LP6005443-DNA_B03,3,78950,188754,188754,0.41827,127280,61474,2.070468816
3625,LP6005443-DNA_B03,4,89590,187818,187818,0.477,126820,60998,2.07908456
3626,LP6005443-DNA_B03,5,65872,152200,152200,0.4328,102500,49700,2.062374245
3627,LP6005443-DNA_B03,6,77111,157110,157110,0.49081,107615,49495,2.174260026
3628,LP6005443-DNA_B03,7,59420,140719,140719,0.42226,95646,45073,2.122024272
3629,LP6005443-DNA_B03,8,61202,136104,136104,0.44967,90299,45805,1.97137867
3630,LP6005443-DNA_B03,9,47928,101623,101623,0.47163,67824,33799,2.006686588
3631,LP6005443-DNA_B03,MT,29,33,33,0.87879,32,1,32
3632,LP6005443-DNA_B03,X,52012,52705,52705,0.98685,35428,17277,2.050587486
3633,LP6005443-DNA_B03,Y,667,679,679,0.98233,407,272,1.496323529
3634,LP6005443-DNA_B04,1,87768,194451,194451,0.45136,133787,60664,2.205377159
3635,LP6005443-DNA_B04,10,54879,127758,127758,0.42955,87694,40064,2.188847843
3636,LP6005443-DNA_B04,11,59932,126616,126616,0.47334,85744,40872,2.09786651
3637,LP6005443-DNA_B04,12,52791,118542,118542,0.44534,81444,37098,2.195374414
3638,LP6005443-DNA_B04,13,48401,105977,105977,0.45671,71858,34119,2.106099241
3639,LP6005443-DNA_B04,14,37835,82380,82380,0.45927,56117,26263,2.136732285
3640,LP6005443-DNA_B04,15,31498,74212,74212,0.42443,50500,23712,2.129723347
3641,LP6005443-DNA_B04,16,30151,70351,70351,0.42858,46074,24277,1.897845698
3642,LP6005443-DNA_B04,17,22408,55420,55420,0.40433,38855,16565,2.34560821
3643,LP6005443-DNA_B04,18,34265,76862,76862,0.4458,52374,24488,2.138761843
3644,LP6005443-DNA_B04,19,15576,39652,39652,0.39282,27927,11725,2.381833689
3645,LP6005443-DNA_B04,2,92444,216393,216393,0.4272,146933,69460,2.115361359
3646,LP6005443-DNA_B04,20,22972,51287,51287,0.44791,35739,15548,2.298623617
3647,LP6005443-DNA_B04,21,16532,34942,34942,0.47313,23702,11240,2.108718861
3648,LP6005443-DNA_B04,22,10402,26692,26692,0.3897,18810,7882,2.38645014
3649,LP6005443-DNA_B04,3,81683,188188,188188,0.43405,126958,61230,2.073460722
3650,LP6005443-DNA_B04,4,91393,196997,196997,0.46393,133040,63957,2.080147599
3651,LP6005443-DNA_B04,5,63771,160593,160593,0.3971,108241,52352,2.067561889
3652,LP6005443-DNA_B04,6,69521,167563,167563,0.41489,114749,52814,2.17270042
3653,LP6005443-DNA_B04,7,57814,142077,142077,0.40692,96663,45414,2.128484608
3654,LP6005443-DNA_B04,8,61101,138241,138241,0.44199,91603,46638,1.964127964
3655,LP6005443-DNA_B04,9,47114,103776,103776,0.454,69152,34624,1.997227357
3656,LP6005443-DNA_B04,MT,38,40,40,0.95,37,3,12.33333333
3657,LP6005443-DNA_B04,X,35326,72537,72537,0.48701,48952,23585,2.075556498
3658,LP6005443-DNA_B06,1,76636,191028,191028,0.40118,131722,59306,2.221056891
3659,LP6005443-DNA_B06,10,52160,120400,120400,0.43322,82588,37812,2.184174336
3660,LP6005443-DNA_B06,11,50165,126521,126521,0.3965,85809,40712,2.107707801
3661,LP6005443-DNA_B06,12,44477,118009,118009,0.37689,81093,36916,2.196689782
3662,LP6005443-DNA_B06,13,43564,101063,101063,0.43106,68929,32134,2.145048858
3663,LP6005443-DNA_B06,14,32488,81198,81198,0.40011,55545,25653,2.165243831
3664,LP6005443-DNA_B06,15,29438,72374,72374,0.40675,49233,23141,2.127522579
3665,LP6005443-DNA_B06,16,28862,71321,71321,0.40468,46825,24496,1.911536577
3666,LP6005443-DNA_B06,17,21417,57898,57898,0.36991,40805,17093,2.38723454
3667,LP6005443-DNA_B06,18,29858,73488,73488,0.4063,50394,23094,2.182125227
3668,LP6005443-DNA_B06,19,14114,40718,40718,0.34663,28691,12027,2.385549181
3669,LP6005443-DNA_B06,2,83659,209693,209693,0.39896,142281,67412,2.110618288
3670,LP6005443-DNA_B06,20,18407,53122,53122,0.3465,37010,16112,2.29704568
3671,LP6005443-DNA_B06,21,13494,35624,35624,0.37879,24269,11355,2.137296345
3672,LP6005443-DNA_B06,22,8898,26800,26800,0.33201,18951,7849,2.4144477
3673,LP6005443-DNA_B06,3,76496,180111,180111,0.42472,121537,58574,2.074930857
3674,LP6005443-DNA_B06,4,77350,186810,186810,0.41406,126370,60440,2.090833885
3675,LP6005443-DNA_B06,5,56962,159803,159803,0.35645,107886,51917,2.078047653
3676,LP6005443-DNA_B06,6,59650,160172,160172,0.37241,109583,50589,2.166142837
3677,LP6005443-DNA_B06,7,51251,134294,134294,0.38163,91537,42757,2.140865823
3678,LP6005443-DNA_B06,8,50605,139993,139993,0.36148,92665,47328,1.95793188
3679,LP6005443-DNA_B06,9,42306,99838,99838,0.42375,66601,33237,2.003821043
3680,LP6005443-DNA_B06,MT,7,10,10,0.7,8,2,4
3681,LP6005443-DNA_B06,X,27501,63889,63889,0.43045,43201,20688,2.088215391
3682,LP6005443-DNA_B07,1,84848,194905,194905,0.43533,134076,60829,2.204146049
3683,LP6005443-DNA_B07,10,53164,125062,125062,0.4251,85923,39139,2.195329467
3684,LP6005443-DNA_B07,11,53514,122039,122039,0.4385,82730,39309,2.104607087
3685,LP6005443-DNA_B07,12,51189,119639,119639,0.42786,82195,37444,2.195144749
3686,LP6005443-DNA_B07,13,43271,98925,98925,0.43741,67403,31522,2.138284373
3687,LP6005443-DNA_B07,14,33141,82776,82776,0.40037,56512,26264,2.151690527
3688,LP6005443-DNA_B07,15,30968,73163,73163,0.42327,49833,23330,2.136005144
3689,LP6005443-DNA_B07,16,29528,73646,73646,0.40095,48164,25482,1.890118515
3690,LP6005443-DNA_B07,17,24175,58278,58278,0.41482,40941,17337,2.361481225
3691,LP6005443-DNA_B07,18,32404,73837,73837,0.43886,50450,23387,2.15718134
3692,LP6005443-DNA_B07,19,15151,42209,42209,0.35895,29627,12582,2.354713082
3693,LP6005443-DNA_B07,2,90399,207543,207543,0.43557,140627,66916,2.101545221
3694,LP6005443-DNA_B07,20,21823,53592,53592,0.40721,37395,16197,2.308760882
3695,LP6005443-DNA_B07,21,13890,33800,33800,0.41095,23053,10747,2.145063739
3696,LP6005443-DNA_B07,22,11907,28455,28455,0.41845,20029,8426,2.377047235
3697,LP6005443-DNA_B07,3,76740,181117,181117,0.4237,122438,58679,2.086572709
3698,LP6005443-DNA_B07,4,83545,186496,186496,0.44797,125951,60545,2.08028739
3699,LP6005443-DNA_B07,5,57878,152042,152042,0.38067,102509,49533,2.069509216
3700,LP6005443-DNA_B07,6,68226,163974,163974,0.41608,112228,51746,2.168824643
3701,LP6005443-DNA_B07,7,57869,136907,136907,0.42269,92939,43968,2.1137873
3702,LP6005443-DNA_B07,8,54700,132067,132067,0.41418,87372,44695,1.954849536
3703,LP6005443-DNA_B07,9,43663,105806,105806,0.41267,70618,35188,2.006877345
3704,LP6005443-DNA_B07,MT,35,39,39,0.89744,37,2,18.5
3705,LP6005443-DNA_B07,X,30828,67538,67538,0.45645,45514,22024,2.066563749
3706,LP6005443-DNA_B08,1,100140,193699,193699,0.51699,133711,59988,2.228962459
3707,LP6005443-DNA_B08,10,63449,122607,122607,0.5175,84339,38268,2.203904045
3708,LP6005443-DNA_B08,11,63758,121546,121546,0.52456,82558,38988,2.117523341
3709,LP6005443-DNA_B08,12,60527,118675,118675,0.51002,81610,37065,2.201807635
3710,LP6005443-DNA_B08,13,50965,99769,99769,0.51083,67871,31898,2.127750956
3711,LP6005443-DNA_B08,14,40219,81061,81061,0.49616,55408,25653,2.159903325
3712,LP6005443-DNA_B08,15,34540,74514,74514,0.46354,50571,23943,2.112141336
3713,LP6005443-DNA_B08,16,35201,73897,73897,0.47635,48718,25179,1.934866357
3714,LP6005443-DNA_B08,17,30646,59639,59639,0.51386,42006,17633,2.382237849
3715,LP6005443-DNA_B08,18,39764,73477,73477,0.54118,50256,23221,2.164247879
3716,LP6005443-DNA_B08,19,20721,45015,45015,0.46031,31725,13290,2.387133183
3717,LP6005443-DNA_B08,2,108867,206018,206018,0.52843,139754,66264,2.109048654
3718,LP6005443-DNA_B08,20,25866,54459,54459,0.47496,37889,16570,2.286602293
3719,LP6005443-DNA_B08,21,17163,37343,37343,0.4596,25441,11902,2.137539909
3720,LP6005443-DNA_B08,22,15013,27018,27018,0.55567,19136,7882,2.4278102
3721,LP6005443-DNA_B08,3,91195,192641,192641,0.47339,130176,62465,2.08398303
3722,LP6005443-DNA_B08,4,92660,186130,186130,0.49782,125881,60249,2.089345881
3723,LP6005443-DNA_B08,5,74270,154712,154712,0.48005,104523,50189,2.082587818
3724,LP6005443-DNA_B08,6,79898,166599,166599,0.47958,113987,52612,2.16655896
3725,LP6005443-DNA_B08,7,64718,134890,134890,0.47978,91427,43463,2.103559349
3726,LP6005443-DNA_B08,8,71270,132857,132857,0.53644,88282,44575,1.980527201
3727,LP6005443-DNA_B08,9,51463,107208,107208,0.48003,71541,35667,2.005803684
3728,LP6005443-DNA_B08,MT,48,49,49,0.97959,47,2,23.5
3729,LP6005443-DNA_B08,X,54328,54993,54993,0.98791,37041,17952,2.063335561
3730,LP6005443-DNA_B08,Y,671,694,694,0.96686,434,260,1.669230769
3731,LP6005443-DNA_B09,1,81535,228679,228679,0.35655,157948,70731,2.233080262
3732,LP6005443-DNA_B09,10,52353,143295,143295,0.36535,98663,44632,2.210588815
3733,LP6005443-DNA_B09,11,50957,148070,148070,0.34414,100649,47421,2.122456296
3734,LP6005443-DNA_B09,12,47663,135156,135156,0.35265,93158,41998,2.218153245
3735,LP6005443-DNA_B09,13,40099,113801,113801,0.35236,77722,36079,2.154217135
3736,LP6005443-DNA_B09,14,37272,97607,97607,0.38186,66704,30903,2.158495939
3737,LP6005443-DNA_B09,15,29429,83724,83724,0.3515,57055,26669,2.139375305
3738,LP6005443-DNA_B09,16,30586,89540,89540,0.34159,58994,30546,1.931316703
3739,LP6005443-DNA_B09,17,24859,75073,75073,0.33113,53107,21966,2.417690977
3740,LP6005443-DNA_B09,18,30997,84974,84974,0.36478,58223,26751,2.176479384
3741,LP6005443-DNA_B09,19,19896,55019,55019,0.36162,38620,16399,2.355021648
3742,LP6005443-DNA_B09,2,87203,254496,254496,0.34265,173036,81460,2.124183648
3743,LP6005443-DNA_B09,20,21591,65008,65008,0.33213,45444,19564,2.322837865
3744,LP6005443-DNA_B09,21,15406,44272,44272,0.34799,30302,13970,2.169076593
3745,LP6005443-DNA_B09,22,12459,36568,36568,0.34071,26034,10534,2.471425859
3746,LP6005443-DNA_B09,3,78206,222031,222031,0.35223,150201,71830,2.09106223
3747,LP6005443-DNA_B09,4,78322,224395,224395,0.34904,151741,72654,2.088542957
3748,LP6005443-DNA_B09,5,64084,196666,196666,0.32585,132962,63704,2.087184478
3749,LP6005443-DNA_B09,6,66214,195825,195825,0.33813,134159,61666,2.175574871
3750,LP6005443-DNA_B09,7,57819,169745,169745,0.34062,115154,54591,2.109395322
3751,LP6005443-DNA_B09,8,59703,170103,170103,0.35098,113238,56865,1.991347929
3752,LP6005443-DNA_B09,9,41865,122729,122729,0.34112,82144,40585,2.023999014
3753,LP6005443-DNA_B09,MT,43,44,44,0.97727,42,2,21
3754,LP6005443-DNA_B09,X,70356,71525,71525,0.98366,47908,23617,2.028538764
3755,LP6005443-DNA_B09,Y,1862,1911,1911,0.97436,1212,699,1.733905579
3756,LP6005443-DNA_B10,1,76670,197173,197173,0.38885,135930,61243,2.219518965
3757,LP6005443-DNA_B10,10,50298,130369,130369,0.38581,89565,40804,2.195005392
3758,LP6005443-DNA_B10,11,51393,129592,129592,0.39658,87948,41644,2.111900874
3759,LP6005443-DNA_B10,12,48180,120020,120020,0.40143,82474,37546,2.196612156
3760,LP6005443-DNA_B10,13,42087,105144,105144,0.40028,71601,33543,2.134603345
3761,LP6005443-DNA_B10,14,32412,84141,84141,0.38521,57399,26742,2.146398923
3762,LP6005443-DNA_B10,15,30242,71939,71939,0.42038,48959,22980,2.130504787
3763,LP6005443-DNA_B10,16,27773,71567,71567,0.38807,46957,24610,1.90804551
3764,LP6005443-DNA_B10,17,22018,58194,58194,0.37836,41008,17186,2.386128244
3765,LP6005443-DNA_B10,18,31570,78385,78385,0.40276,53617,24768,2.164769057
3766,LP6005443-DNA_B10,19,13687,41119,41119,0.33286,28963,12156,2.382609411
3767,LP6005443-DNA_B10,2,82814,219656,219656,0.37702,149010,70646,2.109248931
3768,LP6005443-DNA_B10,20,18738,53085,53085,0.35298,37002,16083,2.30069017
3769,LP6005443-DNA_B10,21,13636,36154,36154,0.37716,24517,11637,2.106814471
3770,LP6005443-DNA_B10,22,10218,27272,27272,0.37467,19318,7954,2.428715112
3771,LP6005443-DNA_B10,3,72324,186797,186797,0.38718,126319,60478,2.088676874
3772,LP6005443-DNA_B10,4,93902,186724,186724,0.50289,126361,60363,2.093351888
3773,LP6005443-DNA_B10,5,61512,165933,165933,0.3707,112099,53834,2.082308578
3774,LP6005443-DNA_B10,6,62266,168614,168614,0.36928,115498,53116,2.174448377
3775,LP6005443-DNA_B10,7,52383,144709,144709,0.36199,98229,46480,2.113360585
3776,LP6005443-DNA_B10,8,53717,144515,144515,0.37171,95862,48653,1.970320432
3777,LP6005443-DNA_B10,9,39042,106023,106023,0.36824,70769,35254,2.007403415
3778,LP6005443-DNA_B10,MT,15,15,15,1,NA,NA,NA
3779,LP6005443-DNA_B10,X,53432,54182,54182,0.98616,36466,17716,2.058365319
3780,LP6005443-DNA_B10,Y,993,1007,1007,0.9861,636,371,1.714285714
3781,LP6005443-DNA_C01,1,89452,199301,199301,0.44883,137233,62068,2.211010505
3782,LP6005443-DNA_C01,10,55306,131668,131668,0.42004,90493,41175,2.197765634
3783,LP6005443-DNA_C01,11,54926,128655,128655,0.42692,87321,41334,2.112570765
3784,LP6005443-DNA_C01,12,52046,126785,126785,0.41051,87020,39765,2.188356595
3785,LP6005443-DNA_C01,13,48754,104937,104937,0.4646,71313,33624,2.120895789
3786,LP6005443-DNA_C01,14,34925,85014,85014,0.41081,57858,27156,2.130578878
3787,LP6005443-DNA_C01,15,31181,75562,75562,0.41265,51379,24183,2.124591655
3788,LP6005443-DNA_C01,16,32550,75646,75646,0.43029,49361,26285,1.877915161
3789,LP6005443-DNA_C01,17,24856,58647,58647,0.42382,41404,17243,2.401206287
3790,LP6005443-DNA_C01,18,32080,75799,75799,0.42322,51704,24095,2.145839386
3791,LP6005443-DNA_C01,2,97992,223007,223007,0.43941,151234,71773,2.107115489
3792,LP6005443-DNA_C01,3,83240,194040,194040,0.42898,130937,63103,2.074972664
3793,LP6005443-DNA_C01,4,89963,200629,200629,0.4484,135525,65104,2.081669329
3794,LP6005443-DNA_C01,5,64545,160237,160237,0.40281,107920,52317,2.062809412
3795,LP6005443-DNA_C01,6,71009,172052,172052,0.41272,117855,54197,2.174566858
3796,LP6005443-DNA_C01,7,60745,144338,144338,0.42085,98171,46167,2.1264323
3797,LP6005443-DNA_C01,8,56118,141474,141474,0.39667,93527,47947,1.950632991
3798,LP6005443-DNA_C01,9,46533,111091,111091,0.41887,74233,36858,2.014026806
3799,LP6005443-DNA_C01,MT,64,87,87,0.73563,49,38,1.289473684
3800,LP6005443-DNA_C01,X,1613,3101,3101,0.52015,2125,976,2.177254098
3801,LP6005443-DNA_C02,1,84062,196805,196805,0.42713,135839,60966,2.22811075
3802,LP6005443-DNA_C02,10,55518,126611,126611,0.43849,86958,39653,2.19297405
3803,LP6005443-DNA_C02,11,54470,126206,126206,0.4316,85598,40608,2.107909771
3804,LP6005443-DNA_C02,12,52789,119504,119504,0.44173,82161,37343,2.200171384
3805,LP6005443-DNA_C02,13,45495,98980,98980,0.45964,67639,31341,2.158163428
3806,LP6005443-DNA_C02,14,33210,83404,83404,0.39818,57125,26279,2.173788957
3807,LP6005443-DNA_C02,15,32305,71815,71815,0.44984,49024,22791,2.151024527
3808,LP6005443-DNA_C02,16,30862,72004,72004,0.42862,47112,24892,1.892656275
3809,LP6005443-DNA_C02,17,24566,59483,59483,0.41299,42112,17371,2.424270336
3810,LP6005443-DNA_C02,18,31368,77029,77029,0.40722,52737,24292,2.170961633
3811,LP6005443-DNA_C02,19,16622,41777,41777,0.39787,29388,12389,2.372104286
3812,LP6005443-DNA_C02,2,94929,211967,211967,0.44785,143932,68035,2.115558169
3813,LP6005443-DNA_C02,20,20833,54516,54516,0.38214,38131,16385,2.327189503
3814,LP6005443-DNA_C02,21,14855,35055,35055,0.42376,23961,11094,2.159816117
3815,LP6005443-DNA_C02,22,11866,27759,27759,0.42746,19649,8110,2.422811344
3816,LP6005443-DNA_C02,3,80322,185052,185052,0.43405,125016,60036,2.08235059
3817,LP6005443-DNA_C02,4,82396,187869,187869,0.43858,126880,60989,2.08037515
3818,LP6005443-DNA_C02,5,61062,156312,156312,0.39064,105599,50713,2.082286593
3819,LP6005443-DNA_C02,6,69576,167158,167158,0.41623,114571,52587,2.178694354
3820,LP6005443-DNA_C02,7,56446,139654,139654,0.40418,95127,44527,2.136389157
3821,LP6005443-DNA_C02,8,54249,135186,135186,0.40129,89283,45903,1.945036272
3822,LP6005443-DNA_C02,9,44445,105584,105584,0.42094,70413,35171,2.002018709
3823,LP6005443-DNA_C02,MT,33,36,36,0.91667,32,4,8
3824,LP6005443-DNA_C02,X,51995,52776,52776,0.9852,35431,17345,2.042721245
3825,LP6005443-DNA_C02,Y,626,646,646,0.96904,410,236,1.737288136
3826,LP6005443-DNA_C03,1,73145,195454,195454,0.37423,134460,60994,2.204479129
3827,LP6005443-DNA_C03,10,46653,126547,126547,0.36866,86842,39705,2.187180456
3828,LP6005443-DNA_C03,11,49336,128208,128208,0.38481,86888,41320,2.102807357
3829,LP6005443-DNA_C03,12,43484,118650,118650,0.36649,81559,37091,2.198889218
3830,LP6005443-DNA_C03,13,45465,105473,105473,0.43106,71686,33787,2.121703614
3831,LP6005443-DNA_C03,14,30895,80636,80636,0.38314,54795,25841,2.120467474
3832,LP6005443-DNA_C03,15,27587,72696,72696,0.37948,49504,23192,2.134529148
3833,LP6005443-DNA_C03,16,25084,70702,70702,0.35478,46212,24490,1.886974275
3834,LP6005443-DNA_C03,17,19381,52824,52824,0.3669,37154,15670,2.371027441
3835,LP6005443-DNA_C03,18,30793,79964,79964,0.38509,54762,25202,2.172922784
3836,LP6005443-DNA_C03,19,12344,35393,35393,0.34877,24855,10538,2.358606946
3837,LP6005443-DNA_C03,2,83433,215397,215397,0.38735,146213,69184,2.11339327
3838,LP6005443-DNA_C03,20,17813,52106,52106,0.34186,36148,15958,2.26519614
3839,LP6005443-DNA_C03,21,12624,36007,36007,0.3506,24445,11562,2.114253589
3840,LP6005443-DNA_C03,22,8470,25614,25614,0.33068,18103,7511,2.410198376
3841,LP6005443-DNA_C03,3,69668,191950,191950,0.36295,129292,62658,2.063455584
3842,LP6005443-DNA_C03,4,80138,198996,198996,0.40271,134478,64518,2.084348554
3843,LP6005443-DNA_C03,5,58696,165329,165329,0.35503,111372,53957,2.06408807
3844,LP6005443-DNA_C03,6,59913,169175,169175,0.35415,115343,53832,2.142647496
3845,LP6005443-DNA_C03,7,52055,139459,139459,0.37326,94701,44758,2.115845212
3846,LP6005443-DNA_C03,8,51014,141359,141359,0.36088,93320,48039,1.942588314
3847,LP6005443-DNA_C03,9,38552,108606,108606,0.35497,72361,36245,1.996440888
3848,LP6005443-DNA_C03,MT,30,33,33,0.90909,32,1,32
3849,LP6005443-DNA_C03,X,50514,51528,51528,0.98032,34705,16823,2.062949533
3850,LP6005443-DNA_C03,Y,382,393,393,0.97201,236,157,1.503184713
3851,LP6005443-DNA_C04,1,85545,192616,192616,0.44412,132699,59917,2.214713687
3852,LP6005443-DNA_C04,10,56132,124747,124747,0.44997,85779,38968,2.201267707
3853,LP6005443-DNA_C04,11,56632,125683,125683,0.45059,85086,40597,2.095869153
3854,LP6005443-DNA_C04,12,50330,115303,115303,0.4365,79158,36145,2.19001245
3855,LP6005443-DNA_C04,13,47997,103881,103881,0.46204,70720,33161,2.132625675
3856,LP6005443-DNA_C04,14,34863,81425,81425,0.42816,55359,26066,2.12380112
3857,LP6005443-DNA_C04,15,31627,71165,71165,0.44442,48355,22810,2.119903551
3858,LP6005443-DNA_C04,16,30387,70938,70938,0.42836,46671,24267,1.923229077
3859,LP6005443-DNA_C04,17,23303,54915,54915,0.42435,38617,16298,2.369431832
3860,LP6005443-DNA_C04,18,34607,77095,77095,0.44889,52765,24330,2.168721743
3861,LP6005443-DNA_C04,19,16484,40512,40512,0.40689,28495,12017,2.371224099
3862,LP6005443-DNA_C04,2,91954,220895,220895,0.41628,149915,70980,2.112073824
3863,LP6005443-DNA_C04,20,19785,52660,52660,0.37571,36667,15993,2.292690552
3864,LP6005443-DNA_C04,21,14723,36119,36119,0.40762,24607,11512,2.137508687
3865,LP6005443-DNA_C04,22,10766,26861,26861,0.4008,19000,7861,2.416995293
3866,LP6005443-DNA_C04,3,82796,185052,185052,0.44742,124974,60078,2.080195746
3867,LP6005443-DNA_C04,4,88555,200062,200062,0.44264,134992,65070,2.074565852
3868,LP6005443-DNA_C04,5,63316,157458,157458,0.40211,106311,51147,2.078538331
3869,LP6005443-DNA_C04,6,72175,166361,166361,0.43385,113652,52709,2.156216206
3870,LP6005443-DNA_C04,7,61215,143186,143186,0.42752,97151,46035,2.110372543
3871,LP6005443-DNA_C04,8,56336,138342,138342,0.40722,91355,46987,1.944261179
3872,LP6005443-DNA_C04,9,48232,101112,101112,0.47702,67452,33660,2.003921569
3873,LP6005443-DNA_C04,MT,32,34,34,0.94118,33,1,33
3874,LP6005443-DNA_C04,X,52456,53279,53279,0.98455,35935,17344,2.071898063
3875,LP6005443-DNA_C04,Y,996,1010,1010,0.98614,640,370,1.72972973
3876,LP6005443-DNA_C06,1,84273,189653,189653,0.44435,130479,59174,2.205005577
3877,LP6005443-DNA_C06,10,54390,124703,124703,0.43616,85648,39055,2.193009858
3878,LP6005443-DNA_C06,11,53800,124535,124535,0.43201,84354,40181,2.099350439
3879,LP6005443-DNA_C06,12,50098,121651,121651,0.41182,83555,38096,2.193274885
3880,LP6005443-DNA_C06,13,48122,103651,103651,0.46427,70450,33201,2.121924038
3881,LP6005443-DNA_C06,14,33521,81139,81139,0.41313,55329,25810,2.143703991
3882,LP6005443-DNA_C06,15,30171,69805,69805,0.43222,47680,22125,2.155028249
3883,LP6005443-DNA_C06,16,30236,70390,70390,0.42955,45877,24513,1.871537552
3884,LP6005443-DNA_C06,17,23728,55738,55738,0.42571,39361,16377,2.403431642
3885,LP6005443-DNA_C06,18,35149,76410,76410,0.46001,52340,24070,2.174491068
3886,LP6005443-DNA_C06,19,13149,35082,35082,0.37481,24618,10464,2.352637615
3887,LP6005443-DNA_C06,2,94786,214503,214503,0.44189,145228,69275,2.096398412
3888,LP6005443-DNA_C06,20,21035,53815,53815,0.39088,37353,16462,2.269043859
3889,LP6005443-DNA_C06,21,15797,35071,35071,0.45043,23890,11181,2.136660406
3890,LP6005443-DNA_C06,22,10720,25592,25592,0.41888,18026,7566,2.382500661
3891,LP6005443-DNA_C06,3,80124,187393,187393,0.42757,126590,60803,2.08196964
3892,LP6005443-DNA_C06,4,89638,198136,198136,0.45241,133645,64491,2.072304663
3893,LP6005443-DNA_C06,5,62949,154934,154934,0.4063,104308,50626,2.06036424
3894,LP6005443-DNA_C06,6,68876,165427,165427,0.41635,113183,52244,2.166430595
3895,LP6005443-DNA_C06,7,58866,140800,140800,0.41808,95862,44938,2.13320575
3896,LP6005443-DNA_C06,8,57173,139340,139340,0.41031,92151,47189,1.952806798
3897,LP6005443-DNA_C06,9,44904,106238,106238,0.42267,70876,35362,2.004298399
3898,LP6005443-DNA_C06,MT,38,42,42,0.90476,39,3,13
3899,LP6005443-DNA_C06,X,33389,75640,75640,0.44142,50827,24813,2.048402047
3900,LP6005443-DNA_C07,1,92073,187512,187512,0.49102,129031,58481,2.20637472
3901,LP6005443-DNA_C07,10,57768,122331,122331,0.47223,84187,38144,2.207083683
3902,LP6005443-DNA_C07,11,61788,115745,115745,0.53383,78398,37347,2.099177979
3903,LP6005443-DNA_C07,12,57756,115043,115043,0.50204,78911,36132,2.183964353
3904,LP6005443-DNA_C07,13,50566,93306,93306,0.54194,63472,29834,2.127505531
3905,LP6005443-DNA_C07,14,39243,78462,78462,0.50015,53536,24926,2.147797481
3906,LP6005443-DNA_C07,15,35689,72225,72225,0.49414,49146,23079,2.129468348
3907,LP6005443-DNA_C07,16,34046,70930,70930,0.47999,46444,24486,1.896757331
3908,LP6005443-DNA_C07,17,27179,57021,57021,0.47665,40074,16947,2.364666313
3909,LP6005443-DNA_C07,18,36188,72410,72410,0.49977,49508,22902,2.1617326
3910,LP6005443-DNA_C07,19,20755,42109,42109,0.49289,29610,12499,2.368989519
3911,LP6005443-DNA_C07,2,102805,197881,197881,0.51953,134178,63703,2.106305825
3912,LP6005443-DNA_C07,20,25080,51657,51657,0.48551,35971,15686,2.293191381
3913,LP6005443-DNA_C07,21,18683,33896,33896,0.55119,23062,10834,2.128669005
3914,LP6005443-DNA_C07,22,13814,28210,28210,0.48968,20033,8177,2.449920509
3915,LP6005443-DNA_C07,3,85618,183786,183786,0.46586,123935,59851,2.070725635
3916,LP6005443-DNA_C07,4,89240,182450,182450,0.48912,123342,59108,2.086722609
3917,LP6005443-DNA_C07,5,71979,148680,148680,0.48412,100357,48323,2.076795729
3918,LP6005443-DNA_C07,6,75366,157518,157518,0.47846,107807,49711,2.168674941
3919,LP6005443-DNA_C07,7,62150,130450,130450,0.47643,88606,41844,2.117531785
3920,LP6005443-DNA_C07,8,66513,130045,130045,0.51146,86182,43863,1.964799489
3921,LP6005443-DNA_C07,9,50096,103823,103823,0.48251,69289,34534,2.00639949
3922,LP6005443-DNA_C07,MT,44,47,47,0.93617,44,3,14.66666667
3923,LP6005443-DNA_C07,X,53256,54456,54456,0.97796,36335,18121,2.005132167
3924,LP6005443-DNA_C07,Y,642,706,706,0.90935,430,276,1.557971014
3925,LP6005443-DNA_C08,1,96797,190720,190720,0.50753,131526,59194,2.22194817
3926,LP6005443-DNA_C08,10,61331,122377,122377,0.50116,84174,38203,2.203334817
3927,LP6005443-DNA_C08,11,64615,121584,121584,0.53144,82356,39228,2.099418783
3928,LP6005443-DNA_C08,12,59983,117819,117819,0.50911,80792,37027,2.181975315
3929,LP6005443-DNA_C08,13,49771,96434,96434,0.51611,65672,30762,2.134841688
3930,LP6005443-DNA_C08,14,37223,83304,83304,0.44683,57058,26246,2.173969367
3931,LP6005443-DNA_C08,15,37367,72634,72634,0.51446,49414,23220,2.128079242
3932,LP6005443-DNA_C08,16,35671,72170,72170,0.49426,47319,24851,1.904108487
3933,LP6005443-DNA_C08,17,29956,58464,58464,0.51238,41234,17230,2.39315148
3934,LP6005443-DNA_C08,18,36929,73761,73761,0.50066,50514,23247,2.172925539
3935,LP6005443-DNA_C08,19,20611,45627,45627,0.45173,32083,13544,2.368797992
3936,LP6005443-DNA_C08,2,111272,202992,202992,0.54816,137571,65421,2.102856881
3937,LP6005443-DNA_C08,20,25043,53597,53597,0.46725,37463,16134,2.321990827
3938,LP6005443-DNA_C08,21,16510,37060,37060,0.44549,25290,11770,2.148683093
3939,LP6005443-DNA_C08,22,14230,28938,28938,0.49174,20461,8477,2.41370768
3940,LP6005443-DNA_C08,3,93330,188791,188791,0.49436,127420,61371,2.076224927
3941,LP6005443-DNA_C08,4,93008,184543,184543,0.50399,124913,59630,2.094801275
3942,LP6005443-DNA_C08,5,73011,156149,156149,0.46757,105473,50676,2.081320546
3943,LP6005443-DNA_C08,6,77885,163442,163442,0.47653,111556,51886,2.1500212
3944,LP6005443-DNA_C08,7,64654,135811,135811,0.47606,92518,43293,2.137019842
3945,LP6005443-DNA_C08,8,68219,133771,133771,0.50997,88680,45091,1.966689583
3946,LP6005443-DNA_C08,9,51623,101578,101578,0.50821,67819,33759,2.008916141
3947,LP6005443-DNA_C08,MT,40,44,44,0.90909,43,1,43
3948,LP6005443-DNA_C08,X,55368,56096,56096,0.98702,37791,18305,2.064517891
3949,LP6005443-DNA_C08,Y,953,973,973,0.97945,617,356,1.733146067
3950,LP6005443-DNA_C09,1,80408,199587,199587,0.40287,137843,61744,2.232492226
3951,LP6005443-DNA_C09,10,51177,127467,127467,0.40149,87775,39692,2.211402802
3952,LP6005443-DNA_C09,11,51735,130840,130840,0.39541,88622,42218,2.09915202
3953,LP6005443-DNA_C09,12,52114,123946,123946,0.42046,85317,38629,2.208625644
3954,LP6005443-DNA_C09,13,45289,104233,104233,0.4345,71121,33112,2.147892003
3955,LP6005443-DNA_C09,14,35250,85797,85797,0.41085,58373,27424,2.128537048
3956,LP6005443-DNA_C09,15,28587,74379,74379,0.38434,50658,23721,2.135576072
3957,LP6005443-DNA_C09,16,30204,75348,75348,0.40086,49410,25938,1.904927134
3958,LP6005443-DNA_C09,17,23115,62620,62620,0.36913,44301,18319,2.41830886
3959,LP6005443-DNA_C09,18,32268,79542,79542,0.40567,54477,25065,2.173429084
3960,LP6005443-DNA_C09,19,16160,43853,43853,0.3685,30889,12964,2.3826751
3961,LP6005443-DNA_C09,2,90512,220194,220194,0.41106,149540,70654,2.11651145
3962,LP6005443-DNA_C09,20,19395,54861,54861,0.35353,38222,16639,2.297133241
3963,LP6005443-DNA_C09,21,14732,37206,37206,0.39596,25329,11877,2.132609245
3964,LP6005443-DNA_C09,22,9736,29526,29526,0.32974,20916,8610,2.429268293
3965,LP6005443-DNA_C09,3,75515,187358,187358,0.40305,126460,60898,2.07658708
3966,LP6005443-DNA_C09,4,81226,199651,199651,0.40684,134869,64782,2.081890031
3967,LP6005443-DNA_C09,5,60483,162795,162795,0.37153,109880,52915,2.076537844
3968,LP6005443-DNA_C09,6,66254,170007,170007,0.38971,116387,53620,2.170589332
3969,LP6005443-DNA_C09,7,56559,147463,147463,0.38355,99998,47465,2.106773412
3970,LP6005443-DNA_C09,8,58082,143429,143429,0.40495,94736,48693,1.945577393
3971,LP6005443-DNA_C09,9,42066,112009,112009,0.37556,74767,37242,2.007598947
3972,LP6005443-DNA_C09,MT,33,34,34,0.97059,33,1,33
3973,LP6005443-DNA_C09,X,52332,53277,53277,0.98226,35889,17388,2.064009662
3974,LP6005443-DNA_C09,Y,692,724,724,0.9558,460,264,1.742424242
3975,LP6005443-DNA_D01,1,77007,199152,199152,0.38667,137778,61374,2.244891974
3976,LP6005443-DNA_D01,10,52459,127661,127661,0.41092,87988,39673,2.217830767
3977,LP6005443-DNA_D01,11,53007,129384,129384,0.40969,88114,41270,2.135061788
3978,LP6005443-DNA_D01,12,46581,123226,123226,0.37801,84887,38339,2.214116174
3979,LP6005443-DNA_D01,13,42572,100774,100774,0.42245,68771,32003,2.148892291
3980,LP6005443-DNA_D01,14,36184,81863,81863,0.44201,56126,25737,2.180751447
3981,LP6005443-DNA_D01,15,29704,75171,75171,0.39515,51394,23777,2.16150061
3982,LP6005443-DNA_D01,16,28004,76562,76562,0.36577,50384,26178,1.92466957
3983,LP6005443-DNA_D01,17,23822,66513,66513,0.35816,47168,19345,2.438252778
3984,LP6005443-DNA_D01,18,30874,76952,76952,0.40121,52875,24077,2.196079246
3985,LP6005443-DNA_D01,19,17134,47374,47374,0.36168,33372,14002,2.383373804
3986,LP6005443-DNA_D01,2,82038,217222,217222,0.37767,147785,69437,2.128332157
3987,LP6005443-DNA_D01,20,19415,54103,54103,0.35885,37877,16226,2.334339948
3988,LP6005443-DNA_D01,21,15356,35230,35230,0.43588,24249,10981,2.208268828
3989,LP6005443-DNA_D01,22,10496,29790,29790,0.35233,21172,8618,2.456718496
3990,LP6005443-DNA_D01,3,70338,180902,180902,0.38882,122515,58387,2.098326682
3991,LP6005443-DNA_D01,4,74587,191786,191786,0.38891,129606,62180,2.084367964
3992,LP6005443-DNA_D01,5,59190,161052,161052,0.36752,108855,52197,2.085464682
3993,LP6005443-DNA_D01,6,60020,168374,168374,0.35647,115427,52947,2.180047973
3994,LP6005443-DNA_D01,7,50631,141340,141340,0.35822,96512,44828,2.152940127
3995,LP6005443-DNA_D01,8,49298,139706,139706,0.35287,92731,46975,1.974050027
3996,LP6005443-DNA_D01,9,40461,106622,106622,0.37948,71505,35117,2.036193297
3997,LP6005443-DNA_D01,MT,32,33,33,0.9697,NA,NA,NA
3998,LP6005443-DNA_D01,X,25320,71871,71871,0.3523,48606,23265,2.089232753
3999,LP6005443-DNA_D02,1,89975,201954,201954,0.44552,139307,62647,2.2236819
4000,LP6005443-DNA_D02,10,56536,127754,127754,0.44254,87952,39802,2.209738204
4001,LP6005443-DNA_D02,11,55992,128239,128239,0.43662,87203,41036,2.125036553
4002,LP6005443-DNA_D02,12,51813,125645,125645,0.41238,86259,39386,2.190092926
4003,LP6005443-DNA_D02,13,45619,99053,99053,0.46055,67692,31361,2.158477089
4004,LP6005443-DNA_D02,14,35609,84515,84515,0.42133,57904,26611,2.17594228
4005,LP6005443-DNA_D02,15,31695,75095,75095,0.42207,51029,24066,2.120377296
4006,LP6005443-DNA_D02,16,30869,78507,78507,0.3932,51557,26950,1.913061224
4007,LP6005443-DNA_D02,17,26489,64041,64041,0.41363,45115,18926,2.383757794
4008,LP6005443-DNA_D02,18,34358,74159,74159,0.4633,50876,23283,2.185113602
4009,LP6005443-DNA_D02,19,18306,48530,48530,0.37721,34110,14420,2.365464632
4010,LP6005443-DNA_D02,2,94253,211031,211031,0.44663,143413,67618,2.120929338
4011,LP6005443-DNA_D02,20,24350,54668,54668,0.44542,38129,16539,2.305399359
4012,LP6005443-DNA_D02,21,16511,33893,33893,0.48715,23242,10651,2.182142522
4013,LP6005443-DNA_D02,22,12397,31494,31494,0.39363,22413,9081,2.468120251
4014,LP6005443-DNA_D02,3,76221,181272,181272,0.42048,122737,58535,2.096813872
4015,LP6005443-DNA_D02,4,86712,185215,185215,0.46817,125354,59861,2.094084629
4016,LP6005443-DNA_D02,5,61008,158701,158701,0.38442,107277,51424,2.0861271
4017,LP6005443-DNA_D02,6,70824,170347,170347,0.41576,116826,53521,2.182806749
4018,LP6005443-DNA_D02,7,59326,142451,142451,0.41647,96911,45540,2.128041282
4019,LP6005443-DNA_D02,8,57631,137513,137513,0.41909,91375,46138,1.980471629
4020,LP6005443-DNA_D02,9,42895,110073,110073,0.3897,73796,36277,2.034236569
4021,LP6005443-DNA_D02,MT,33,36,36,0.91667,34,2,17
4022,LP6005443-DNA_D02,X,52898,53587,53587,0.98714,35898,17689,2.0293968
4023,LP6005443-DNA_D02,Y,676,700,700,0.96571,440,260,1.692307692
4024,LP6005443-DNA_D03,1,88138,186258,186258,0.4732,128084,58174,2.201739609
4025,LP6005443-DNA_D03,10,54623,122419,122419,0.4462,84148,38271,2.198740561
4026,LP6005443-DNA_D03,11,58062,120767,120767,0.48078,81749,39018,2.095161208
4027,LP6005443-DNA_D03,12,54709,114439,114439,0.47806,78612,35827,2.19421107
4028,LP6005443-DNA_D03,13,49816,101607,101607,0.49028,68955,32652,2.111815509
4029,LP6005443-DNA_D03,14,37120,82676,82676,0.44898,56158,26518,2.117731352
4030,LP6005443-DNA_D03,15,32383,67929,67929,0.47672,46089,21840,2.110302198
4031,LP6005443-DNA_D03,16,30120,66790,66790,0.45097,43710,23080,1.893847487
4032,LP6005443-DNA_D03,17,27478,44903,44903,0.61194,31679,13224,2.395568663
4033,LP6005443-DNA_D03,18,35038,77588,77588,0.45159,53154,24434,2.175411312
4034,LP6005443-DNA_D03,19,12852,32171,32171,0.39949,22546,9625,2.342441558
4035,LP6005443-DNA_D03,2,102334,205360,205360,0.49832,139164,66196,2.102302254
4036,LP6005443-DNA_D03,20,21553,47961,47961,0.44939,33428,14533,2.300144499
4037,LP6005443-DNA_D03,21,15652,33445,33445,0.46799,22705,10740,2.11405959
4038,LP6005443-DNA_D03,22,10157,24443,24443,0.41554,17250,7193,2.398164883
4039,LP6005443-DNA_D03,3,84459,184444,184444,0.45791,124397,60047,2.071660533
4040,LP6005443-DNA_D03,4,91276,194499,194499,0.46929,131340,63159,2.079513609
4041,LP6005443-DNA_D03,5,66442,156883,156883,0.42351,105677,51206,2.063762059
4042,LP6005443-DNA_D03,6,75484,161203,161203,0.46825,110139,51064,2.15688156
4043,LP6005443-DNA_D03,7,65521,131354,131354,0.49881,88861,42493,2.09119149
4044,LP6005443-DNA_D03,8,63966,129687,129687,0.49323,85369,44318,1.926282774
4045,LP6005443-DNA_D03,9,48629,101376,101376,0.47969,67389,33987,1.982787536
4046,LP6005443-DNA_D03,MT,31,33,33,0.93939,NA,NA,NA
4047,LP6005443-DNA_D03,X,50948,51870,51870,0.98222,34946,16924,2.064878279
4048,LP6005443-DNA_D03,Y,677,703,703,0.96302,430,273,1.575091575
4049,LP6005443-DNA_D04,1,93214,190946,190946,0.48817,131133,59813,2.192382927
4050,LP6005443-DNA_D04,10,54689,125934,125934,0.43427,86422,39512,2.187234258
4051,LP6005443-DNA_D04,11,55069,128589,128589,0.42826,86979,41610,2.090338861
4052,LP6005443-DNA_D04,12,54384,120518,120518,0.45125,82489,38029,2.169107786
4053,LP6005443-DNA_D04,13,50118,104645,104645,0.47893,71114,33531,2.120843399
4054,LP6005443-DNA_D04,14,35906,81391,81391,0.44115,55502,25889,2.143844876
4055,LP6005443-DNA_D04,15,30681,74964,74964,0.40928,51031,23933,2.132244182
4056,LP6005443-DNA_D04,16,29927,72108,72108,0.41503,47214,24894,1.896601591
4057,LP6005443-DNA_D04,17,25459,54157,54157,0.4701,38155,16002,2.384389451
4058,LP6005443-DNA_D04,18,38238,75106,75106,0.50912,51339,23767,2.160095931
4059,LP6005443-DNA_D04,19,15922,39783,39783,0.40022,27843,11940,2.331909548
4060,LP6005443-DNA_D04,2,101472,213703,213703,0.47483,144970,68733,2.109176087
4061,LP6005443-DNA_D04,20,21080,52208,52208,0.40377,36280,15928,2.277749874
4062,LP6005443-DNA_D04,21,15334,34239,34239,0.44785,23314,10925,2.134004577
4063,LP6005443-DNA_D04,22,11692,26293,26293,0.44468,18665,7628,2.446906135
4064,LP6005443-DNA_D04,3,88970,181335,181335,0.49064,122115,59220,2.062056738
4065,LP6005443-DNA_D04,4,96030,193500,193500,0.49628,130513,62987,2.072062489
4066,LP6005443-DNA_D04,5,75135,152953,152953,0.49123,102947,50006,2.058692957
4067,LP6005443-DNA_D04,6,79167,158441,158441,0.49966,108473,49968,2.170849344
4068,LP6005443-DNA_D04,7,65535,140229,140229,0.46734,95225,45004,2.115923029
4069,LP6005443-DNA_D04,8,62765,136943,136943,0.45833,90577,46366,1.953521977
4070,LP6005443-DNA_D04,9,48398,104788,104788,0.46187,69697,35091,1.986178792
4071,LP6005443-DNA_D04,MT,35,36,36,0.97222,NA,NA,NA
4072,LP6005443-DNA_D04,X,31853,73705,73705,0.43217,49689,24016,2.06899567
4073,LP6005443-DNA_D05,1,78199,196022,196022,0.39893,135052,60970,2.215056585
4074,LP6005443-DNA_D05,10,53073,124728,124728,0.42551,85583,39145,2.186307319
4075,LP6005443-DNA_D05,11,48900,126453,126453,0.3867,86005,40448,2.126310324
4076,LP6005443-DNA_D05,12,49894,116996,116996,0.42646,80119,36877,2.172600808
4077,LP6005443-DNA_D05,13,48143,103228,103228,0.46638,70227,33001,2.128026423
4078,LP6005443-DNA_D05,14,32686,78826,78826,0.41466,53628,25198,2.128264148
4079,LP6005443-DNA_D05,15,33379,68026,68026,0.49068,46318,21708,2.133683435
4080,LP6005443-DNA_D05,16,30169,72036,72036,0.4188,47043,24993,1.882247029
4081,LP6005443-DNA_D05,17,21526,57625,57625,0.37355,40604,17021,2.385523765
4082,LP6005443-DNA_D05,18,30472,77172,77172,0.39486,52835,24337,2.170974237
4083,LP6005443-DNA_D05,19,13593,41266,41266,0.3294,29026,12240,2.371405229
4084,LP6005443-DNA_D05,2,88830,212806,212806,0.41742,144274,68532,2.105206327
4085,LP6005443-DNA_D05,20,21699,51969,51969,0.41754,36161,15808,2.287512652
4086,LP6005443-DNA_D05,21,13793,34619,34619,0.39842,23676,10943,2.163574888
4087,LP6005443-DNA_D05,22,9842,27364,27364,0.35967,19479,7885,2.47038681
4088,LP6005443-DNA_D05,3,71192,187083,187083,0.38054,126338,60745,2.079809038
4089,LP6005443-DNA_D05,4,77125,191240,191240,0.40329,129405,61835,2.092746826
4090,LP6005443-DNA_D05,5,57510,160663,160663,0.35795,108367,52296,2.072185253
4091,LP6005443-DNA_D05,6,68503,158994,158994,0.43085,108617,50377,2.156083133
4092,LP6005443-DNA_D05,7,52328,140451,140451,0.37257,95573,44878,2.129618076
4093,LP6005443-DNA_D05,8,52043,137549,137549,0.37836,91272,46277,1.972297253
4094,LP6005443-DNA_D05,9,41391,109752,109752,0.37713,73450,36302,2.023304501
4095,LP6005443-DNA_D05,MT,37,39,39,0.94872,38,1,38
4096,LP6005443-DNA_D05,X,29505,73182,73182,0.40317,49404,23778,2.0777189
4097,LP6005443-DNA_D06,1,86486,198476,198476,0.43575,136816,61660,2.218877717
4098,LP6005443-DNA_D06,10,56578,128766,128766,0.43939,88403,40363,2.190198945
4099,LP6005443-DNA_D06,11,54143,128203,128203,0.42232,86776,41427,2.094672557
4100,LP6005443-DNA_D06,12,52639,120588,120588,0.43652,83135,37453,2.219715377
4101,LP6005443-DNA_D06,13,48390,96564,96564,0.50112,65744,30820,2.133160286
4102,LP6005443-DNA_D06,14,35544,84686,84686,0.41972,57725,26961,2.141055599
4103,LP6005443-DNA_D06,15,32079,75745,75745,0.42351,51621,24124,2.139819267
4104,LP6005443-DNA_D06,16,30378,74680,74680,0.40678,48856,25824,1.891883519
4105,LP6005443-DNA_D06,17,25732,59282,59282,0.43406,41673,17609,2.366573911
4106,LP6005443-DNA_D06,18,32778,76203,76203,0.43014,52413,23790,2.203152585
4107,LP6005443-DNA_D06,19,17059,44191,44191,0.38603,31067,13124,2.367189881
4108,LP6005443-DNA_D06,2,95556,212652,212652,0.44935,144225,68427,2.107720637
4109,LP6005443-DNA_D06,20,21282,53975,53975,0.39429,37700,16275,2.316436252
4110,LP6005443-DNA_D06,21,14419,33836,33836,0.42614,23120,10716,2.157521463
4111,LP6005443-DNA_D06,22,11730,29304,29304,0.40029,20751,8553,2.426166257
4112,LP6005443-DNA_D06,3,80637,185363,185363,0.43502,125288,60075,2.085526425
4113,LP6005443-DNA_D06,4,82843,189313,189313,0.4376,127769,61544,2.076059405
4114,LP6005443-DNA_D06,5,63450,153547,153547,0.41323,103521,50026,2.069343941
4115,LP6005443-DNA_D06,6,71425,166921,166921,0.4279,114006,52915,2.154511953
4116,LP6005443-DNA_D06,7,58609,139745,139745,0.4194,94883,44862,2.114997102
4117,LP6005443-DNA_D06,8,57519,134186,134186,0.42865,88732,45454,1.952127426
4118,LP6005443-DNA_D06,9,44948,104922,104922,0.42839,70287,34635,2.029363361
4119,LP6005443-DNA_D06,MT,35,42,42,0.83333,39,3,13
4120,LP6005443-DNA_D06,X,50765,51470,51470,0.9863,34681,16789,2.065697778
4121,LP6005443-DNA_D06,Y,659,691,691,0.95369,447,244,1.831967213
4122,LP6005443-DNA_D07,1,98188,188531,188531,0.52081,129765,58766,2.208164585
4123,LP6005443-DNA_D07,10,60221,123683,123683,0.4869,85155,38528,2.210210756
4124,LP6005443-DNA_D07,11,60462,120078,120078,0.50352,81206,38872,2.089061535
4125,LP6005443-DNA_D07,12,59242,117404,117404,0.5046,80568,36836,2.187208166
4126,LP6005443-DNA_D07,13,53845,95847,95847,0.56178,65059,30788,2.113128492
4127,LP6005443-DNA_D07,14,44610,78600,78600,0.56756,53608,24992,2.145006402
4128,LP6005443-DNA_D07,15,35684,71809,71809,0.49693,48731,23078,2.111578126
4129,LP6005443-DNA_D07,16,36317,69558,69558,0.52211,45539,24019,1.895957367
4130,LP6005443-DNA_D07,17,27116,56805,56805,0.47735,40018,16787,2.38386847
4131,LP6005443-DNA_D07,18,35477,76132,76132,0.46599,51994,24138,2.154030988
4132,LP6005443-DNA_D07,19,19130,40372,40372,0.47384,28397,11975,2.371356994
4133,LP6005443-DNA_D07,2,112668,202887,202887,0.55532,137391,65496,2.097700623
4134,LP6005443-DNA_D07,20,24473,51897,51897,0.47157,36232,15665,2.312926907
4135,LP6005443-DNA_D07,21,15545,34917,34917,0.4452,23732,11185,2.121770228
4136,LP6005443-DNA_D07,22,13746,25420,25420,0.54076,17965,7455,2.409792086
4137,LP6005443-DNA_D07,3,93634,190813,190813,0.49071,128758,62055,2.074901297
4138,LP6005443-DNA_D07,4,93537,186864,186864,0.50056,126314,60550,2.086110652
4139,LP6005443-DNA_D07,5,73639,158597,158597,0.46432,106934,51663,2.069837214
4140,LP6005443-DNA_D07,6,78946,164566,164566,0.47972,112523,52043,2.162115943
4141,LP6005443-DNA_D07,7,64905,135742,135742,0.47815,91941,43801,2.099061665
4142,LP6005443-DNA_D07,8,72601,133748,133748,0.54282,88616,45132,1.963484889
4143,LP6005443-DNA_D07,9,53202,106930,106930,0.49754,71289,35641,2.000196403
4144,LP6005443-DNA_D07,MT,45,49,49,0.91837,48,1,48
4145,LP6005443-DNA_D07,X,53166,54130,54130,0.98219,36390,17740,2.051296505
4146,LP6005443-DNA_D07,Y,910,932,932,0.97639,590,342,1.725146199
4147,LP6005443-DNA_D08,1,97564,192282,192282,0.5074,132543,59739,2.218701351
4148,LP6005443-DNA_D08,10,61547,122416,122416,0.50277,84346,38070,2.215550302
4149,LP6005443-DNA_D08,11,62606,122087,122087,0.5128,82973,39114,2.121312062
4150,LP6005443-DNA_D08,12,61063,120423,120423,0.50707,82715,37708,2.193566352
4151,LP6005443-DNA_D08,13,50355,96468,96468,0.52199,65710,30758,2.136354769
4152,LP6005443-DNA_D08,14,41592,83191,83191,0.49996,56958,26233,2.171234704
4153,LP6005443-DNA_D08,15,34567,73269,73269,0.47178,49771,23498,2.118095157
4154,LP6005443-DNA_D08,16,33884,73154,73154,0.46319,48018,25136,1.910327817
4155,LP6005443-DNA_D08,17,30427,59384,59384,0.51238,41787,17597,2.374666136
4156,LP6005443-DNA_D08,18,38497,73864,73864,0.52119,50637,23227,2.180092134
4157,LP6005443-DNA_D08,19,21080,45880,45880,0.45946,32365,13515,2.394746578
4158,LP6005443-DNA_D08,2,108817,204264,204264,0.53273,138617,65647,2.111551175
4159,LP6005443-DNA_D08,20,24858,53930,53930,0.46093,37596,16334,2.301701971
4160,LP6005443-DNA_D08,21,16550,37497,37497,0.44137,25602,11895,2.152332913
4161,LP6005443-DNA_D08,22,14348,29535,29535,0.4858,20889,8646,2.416030534
4162,LP6005443-DNA_D08,3,89197,188534,188534,0.47311,127178,61356,2.072788317
4163,LP6005443-DNA_D08,4,94861,185213,185213,0.51217,125040,60173,2.078008409
4164,LP6005443-DNA_D08,5,73117,152948,152948,0.47805,103580,49368,2.09812024
4165,LP6005443-DNA_D08,6,80733,160228,160228,0.50386,109650,50578,2.167938629
4166,LP6005443-DNA_D08,7,64572,134514,134514,0.48004,91434,43080,2.122423398
4167,LP6005443-DNA_D08,8,69009,135782,135782,0.50823,90204,45578,1.97911273
4168,LP6005443-DNA_D08,9,52794,105333,105333,0.50121,70441,34892,2.018829531
4169,LP6005443-DNA_D08,MT,44,49,49,0.89796,46,3,15.33333333
4170,LP6005443-DNA_D08,X,35384,70550,70550,0.50155,47654,22896,2.081324249
4171,LP6005443-DNA_D09,1,104550,179106,179106,0.58373,123475,55631,2.21953587
4172,LP6005443-DNA_D09,10,60285,121805,121805,0.49493,83709,38096,2.197317304
4173,LP6005443-DNA_D09,11,65002,117563,117563,0.55291,79802,37761,2.113344456
4174,LP6005443-DNA_D09,12,59181,111129,111129,0.53254,76312,34817,2.191802855
4175,LP6005443-DNA_D09,13,53467,95745,95745,0.55843,65433,30312,2.15865004
4176,LP6005443-DNA_D09,14,43032,75786,75786,0.56781,51566,24220,2.129066887
4177,LP6005443-DNA_D09,15,33283,69752,69752,0.47716,47488,22264,2.132950054
4178,LP6005443-DNA_D09,16,32964,72766,72766,0.45301,47872,24894,1.923033663
4179,LP6005443-DNA_D09,17,27592,58108,58108,0.47484,41061,17047,2.408693612
4180,LP6005443-DNA_D09,18,35443,72442,72442,0.48926,49752,22690,2.192684002
4181,LP6005443-DNA_D09,19,20141,40570,40570,0.49645,28572,11998,2.381396899
4182,LP6005443-DNA_D09,2,109740,198820,198820,0.55196,134991,63829,2.114885084
4183,LP6005443-DNA_D09,20,24901,52238,52238,0.47668,36529,15709,2.325354892
4184,LP6005443-DNA_D09,21,16166,34339,34339,0.47078,23348,10991,2.124283505
4185,LP6005443-DNA_D09,22,14559,25677,25677,0.56701,18191,7486,2.430002672
4186,LP6005443-DNA_D09,3,88347,175551,175551,0.50326,118503,57048,2.077250736
4187,LP6005443-DNA_D09,4,97805,181974,181974,0.53747,122867,59107,2.07872164
4188,LP6005443-DNA_D09,5,74056,151185,151185,0.48984,102103,49082,2.080253453
4189,LP6005443-DNA_D09,6,84125,149792,149792,0.56161,102529,47263,2.169329073
4190,LP6005443-DNA_D09,7,68241,133601,133601,0.51078,91087,42514,2.142517759
4191,LP6005443-DNA_D09,8,61957,133973,133973,0.46246,88420,45553,1.941035717
4192,LP6005443-DNA_D09,9,48500,106079,106079,0.45721,70907,35172,2.016007051
4193,LP6005443-DNA_D09,MT,38,39,39,0.97436,NA,NA,NA
4194,LP6005443-DNA_D09,X,53316,53928,53928,0.98865,36281,17647,2.055930186
4195,LP6005443-DNA_D09,Y,699,725,725,0.96414,458,267,1.715355805
4196,LP6005443-DNA_E01,1,90995,197717,197717,0.46023,136524,61193,2.231039498
4197,LP6005443-DNA_E01,10,60195,128528,128528,0.46834,88505,40023,2.211353472
4198,LP6005443-DNA_E01,11,60649,123657,123657,0.49046,83875,39782,2.108365592
4199,LP6005443-DNA_E01,12,53208,121151,121151,0.43919,83363,37788,2.20607071
4200,LP6005443-DNA_E01,13,46003,99817,99817,0.46087,68302,31515,2.16728542
4201,LP6005443-DNA_E01,14,35602,83244,83244,0.42768,56908,26336,2.160844471
4202,LP6005443-DNA_E01,15,32401,75709,75709,0.42797,51650,24059,2.146805769
4203,LP6005443-DNA_E01,16,33229,75765,75765,0.43858,49504,26261,1.88507673
4204,LP6005443-DNA_E01,17,25908,59986,59986,0.4319,42380,17606,2.407133932
4205,LP6005443-DNA_E01,18,36836,72166,72166,0.51043,49548,22618,2.190644619
4206,LP6005443-DNA_E01,19,16368,41792,41792,0.39165,29445,12347,2.384789827
4207,LP6005443-DNA_E01,2,98557,216974,216974,0.45423,147398,69576,2.11851788
4208,LP6005443-DNA_E01,20,22760,55720,55720,0.40847,38837,16883,2.30036131
4209,LP6005443-DNA_E01,21,14334,34034,34034,0.42117,23170,10864,2.132731959
4210,LP6005443-DNA_E01,22,11381,29329,29329,0.38805,20788,8541,2.433907037
4211,LP6005443-DNA_E01,3,80540,183641,183641,0.43857,124038,59603,2.081069745
4212,LP6005443-DNA_E01,4,82583,192480,192480,0.42905,130239,62241,2.092495301
4213,LP6005443-DNA_E01,5,64382,152643,152643,0.42178,103198,49445,2.087127111
4214,LP6005443-DNA_E01,6,70429,166411,166411,0.42322,114201,52210,2.18733959
4215,LP6005443-DNA_E01,7,58799,140944,140944,0.41718,95853,45091,2.125767892
4216,LP6005443-DNA_E01,8,56792,141122,141122,0.40243,93570,47552,1.967740579
4217,LP6005443-DNA_E01,9,48449,103675,103675,0.46732,69454,34221,2.029572485
4218,LP6005443-DNA_E01,MT,40,42,42,0.95238,41,1,41
4219,LP6005443-DNA_E01,X,53622,54195,54195,0.98943,36286,17909,2.026132112
4220,LP6005443-DNA_E01,Y,687,692,692,0.99277,422,270,1.562962963
4221,LP6005443-DNA_E02,1,83684,229573,229573,0.36452,158413,71160,2.226152333
4222,LP6005443-DNA_E02,10,50685,151286,151286,0.33503,104149,47137,2.209495725
4223,LP6005443-DNA_E02,11,51748,149103,149103,0.34706,101454,47649,2.129194737
4224,LP6005443-DNA_E02,12,47917,140908,140908,0.34006,97117,43791,2.217738805
4225,LP6005443-DNA_E02,13,40110,116119,116119,0.34542,79063,37056,2.133608592
4226,LP6005443-DNA_E02,14,34115,102907,102907,0.33151,70484,32423,2.173888906
4227,LP6005443-DNA_E02,15,28819,91628,91628,0.31452,62428,29200,2.137945205
4228,LP6005443-DNA_E02,16,31839,94475,94475,0.33701,62230,32245,1.929911614
4229,LP6005443-DNA_E02,17,24532,77238,77238,0.31762,54475,22763,2.393137987
4230,LP6005443-DNA_E02,18,32613,90286,90286,0.36122,61939,28347,2.185028398
4231,LP6005443-DNA_E02,19,20841,57283,57283,0.36383,40538,16745,2.420901762
4232,LP6005443-DNA_E02,2,91865,259053,259053,0.35462,176028,83025,2.120180668
4233,LP6005443-DNA_E02,20,23019,68472,68472,0.33618,47737,20735,2.302242585
4234,LP6005443-DNA_E02,21,16869,45974,45974,0.36692,31311,14663,2.135374753
4235,LP6005443-DNA_E02,22,13109,37301,37301,0.35144,26393,10908,2.419600293
4236,LP6005443-DNA_E02,3,79645,224302,224302,0.35508,151644,72658,2.087092956
4237,LP6005443-DNA_E02,4,77641,229387,229387,0.33847,154895,74492,2.079350803
4238,LP6005443-DNA_E02,5,66872,202983,202983,0.32945,137250,65733,2.087992333
4239,LP6005443-DNA_E02,6,64687,198848,198848,0.32531,136242,62606,2.176181197
4240,LP6005443-DNA_E02,7,61142,178636,178636,0.34227,121298,57338,2.1154906
4241,LP6005443-DNA_E02,8,63050,183479,183479,0.34364,121948,61531,1.981895305
4242,LP6005443-DNA_E02,9,45972,133636,133636,0.34401,89476,44160,2.026177536
4243,LP6005443-DNA_E02,MT,41,44,44,0.93182,42,2,21
4244,LP6005443-DNA_E02,X,75135,76167,76167,0.98645,51107,25060,2.039385475
4245,LP6005443-DNA_E02,Y,956,984,984,0.97154,621,363,1.710743802
4246,LP6005443-DNA_E05,1,75395,194054,194054,0.38853,133639,60415,2.212016883
4247,LP6005443-DNA_E05,10,49535,126478,126478,0.39165,86851,39627,2.191712721
4248,LP6005443-DNA_E05,11,48145,128102,128102,0.37583,86741,41361,2.097168831
4249,LP6005443-DNA_E05,12,44634,120667,120667,0.36989,82864,37803,2.191995344
4250,LP6005443-DNA_E05,13,44904,104424,104424,0.43002,71032,33392,2.1272161
4251,LP6005443-DNA_E05,14,32266,81287,81287,0.39694,55425,25862,2.143105715
4252,LP6005443-DNA_E05,15,28198,73904,73904,0.38155,50293,23611,2.130066494
4253,LP6005443-DNA_E05,16,27201,72731,72731,0.37399,47795,24936,1.916706769
4254,LP6005443-DNA_E05,17,19314,56752,56752,0.34032,40028,16724,2.393446544
4255,LP6005443-DNA_E05,18,31134,78881,78881,0.3947,53996,24885,2.169821177
4256,LP6005443-DNA_E05,19,14301,39145,39145,0.36533,27509,11636,2.364128567
4257,LP6005443-DNA_E05,2,84155,213839,213839,0.39354,145060,68779,2.109073991
4258,LP6005443-DNA_E05,20,17636,51227,51227,0.34427,35606,15621,2.279367518
4259,LP6005443-DNA_E05,21,12822,35454,35454,0.36165,24197,11257,2.149506973
4260,LP6005443-DNA_E05,22,9121,25735,25735,0.35442,18146,7589,2.391092371
4261,LP6005443-DNA_E05,3,70878,183736,183736,0.38576,124158,59578,2.083957165
4262,LP6005443-DNA_E05,4,80067,195896,195896,0.40872,132371,63525,2.083762298
4263,LP6005443-DNA_E05,5,58730,160795,160795,0.36525,108570,52225,2.078889421
4264,LP6005443-DNA_E05,6,62550,167390,167390,0.37368,114419,52971,2.16003096
4265,LP6005443-DNA_E05,7,51860,142485,142485,0.36397,96692,45793,2.111501758
4266,LP6005443-DNA_E05,8,50116,140814,140814,0.3559,93275,47539,1.962073245
4267,LP6005443-DNA_E05,9,37578,106443,106443,0.35303,71038,35405,2.006439768
4268,LP6005443-DNA_E05,MT,37,37,37,1,36,1,36
4269,LP6005443-DNA_E05,X,47072,47920,47920,0.9823,32315,15605,2.070810638
4270,LP6005443-DNA_E05,Y,657,663,663,0.99095,409,254,1.61023622
4271,LP6005443-DNA_E06,1,77342,238072,238072,0.32487,164535,73537,2.237445096
4272,LP6005443-DNA_E06,10,50016,156024,156024,0.32057,107400,48624,2.208785785
4273,LP6005443-DNA_E06,11,52287,154081,154081,0.33935,104847,49234,2.129564935
4274,LP6005443-DNA_E06,12,49049,147807,147807,0.33184,101439,46368,2.187694099
4275,LP6005443-DNA_E06,13,40494,117419,117419,0.34487,80023,37396,2.139881271
4276,LP6005443-DNA_E06,14,35039,103786,103786,0.33761,71033,32753,2.168747901
4277,LP6005443-DNA_E06,15,27959,91310,91310,0.3062,62076,29234,2.123417938
4278,LP6005443-DNA_E06,16,31152,96014,96014,0.32445,63167,32847,1.923067556
4279,LP6005443-DNA_E06,17,25474,78675,78675,0.32379,55647,23028,2.416492965
4280,LP6005443-DNA_E06,18,31359,91886,91886,0.34128,62990,28896,2.179886489
4281,LP6005443-DNA_E06,19,19974,61145,61145,0.32667,43129,18016,2.39392762
4282,LP6005443-DNA_E06,2,88912,262190,262190,0.33911,178106,84084,2.118191332
4283,LP6005443-DNA_E06,20,22477,68087,68087,0.33012,47481,20606,2.304231777
4284,LP6005443-DNA_E06,21,16053,48961,48961,0.32787,33432,15529,2.152875266
4285,LP6005443-DNA_E06,22,11540,36880,36880,0.31291,26193,10687,2.450921681
4286,LP6005443-DNA_E06,3,73613,223531,223531,0.32932,151204,72327,2.090560925
4287,LP6005443-DNA_E06,4,79270,232293,232293,0.34125,157186,75107,2.092827566
4288,LP6005443-DNA_E06,5,63893,202421,202421,0.31564,137162,65259,2.101809712
4289,LP6005443-DNA_E06,6,68175,203520,203520,0.33498,139639,63881,2.185923827
4290,LP6005443-DNA_E06,7,58481,177184,177184,0.33006,120656,56528,2.134446646
4291,LP6005443-DNA_E06,8,57925,176622,176622,0.32796,117742,58880,1.999694293
4292,LP6005443-DNA_E06,9,42343,129789,129789,0.32624,86812,42977,2.019964167
4293,LP6005443-DNA_E06,MT,82,89,89,0.92135,85,4,21.25
4294,LP6005443-DNA_E06,X,3471,5450,5450,0.63688,3626,1824,1.987938596
4295,LP6005443-DNA_E07,1,94246,185640,185640,0.50768,127747,57893,2.206605289
4296,LP6005443-DNA_E07,10,57689,113670,113670,0.50751,77915,35755,2.179135785
4297,LP6005443-DNA_E07,11,60205,117127,117127,0.51401,79258,37869,2.092952019
4298,LP6005443-DNA_E07,12,58607,115276,115276,0.50841,78961,36315,2.174335674
4299,LP6005443-DNA_E07,13,50023,93882,93882,0.53283,63838,30044,2.124816935
4300,LP6005443-DNA_E07,14,37756,80436,80436,0.46939,54821,25615,2.140191294
4301,LP6005443-DNA_E07,15,32950,72000,72000,0.45764,48978,23022,2.127443315
4302,LP6005443-DNA_E07,16,34110,68763,68763,0.49605,45216,23547,1.920244617
4303,LP6005443-DNA_E07,17,26096,57180,57180,0.45638,40120,17060,2.351699883
4304,LP6005443-DNA_E07,18,36330,72737,72737,0.49947,49811,22926,2.172686033
4305,LP6005443-DNA_E07,19,19410,41222,41222,0.47087,29014,12208,2.37663827
4306,LP6005443-DNA_E07,2,107125,197606,197606,0.54211,133821,63785,2.098001097
4307,LP6005443-DNA_E07,20,23942,52237,52237,0.45833,36291,15946,2.275868556
4308,LP6005443-DNA_E07,21,18451,32663,32663,0.56489,22152,10511,2.107506422
4309,LP6005443-DNA_E07,22,13137,26546,26546,0.49488,18798,7748,2.426174497
4310,LP6005443-DNA_E07,3,91346,178853,178853,0.51073,120773,58080,2.079424931
4311,LP6005443-DNA_E07,4,91690,181226,181226,0.50594,122272,58954,2.074023815
4312,LP6005443-DNA_E07,5,70019,149278,149278,0.46905,100598,48680,2.066516023
4313,LP6005443-DNA_E07,6,78909,157514,157514,0.50096,107554,49960,2.152802242
4314,LP6005443-DNA_E07,7,64498,130548,130548,0.49406,88953,41595,2.138550307
4315,LP6005443-DNA_E07,8,68164,130406,130406,0.52271,86341,44065,1.959400885
4316,LP6005443-DNA_E07,9,51451,99327,99327,0.518,65986,33341,1.979124801
4317,LP6005443-DNA_E07,MT,25,26,26,0.96154,NA,NA,NA
4318,LP6005443-DNA_E07,X,50240,51258,51258,0.98014,34349,16909,2.031403395
4319,LP6005443-DNA_E07,Y,630,647,647,0.97372,404,243,1.66255144
4320,LP6005443-DNA_E08,1,98928,194301,194301,0.50915,134109,60192,2.228020335
4321,LP6005443-DNA_E08,10,57667,125185,125185,0.46065,86030,39155,2.197165113
4322,LP6005443-DNA_E08,11,63998,119172,119172,0.53702,81009,38163,2.122710479
4323,LP6005443-DNA_E08,12,59515,120508,120508,0.49387,82902,37606,2.204488645
4324,LP6005443-DNA_E08,13,50420,94702,94702,0.53241,64633,30069,2.149489507
4325,LP6005443-DNA_E08,14,40923,81106,81106,0.50456,55354,25752,2.149502951
4326,LP6005443-DNA_E08,15,36287,74670,74670,0.48596,50637,24033,2.106977905
4327,LP6005443-DNA_E08,16,36970,75508,75508,0.48962,49625,25883,1.917281613
4328,LP6005443-DNA_E08,17,28777,61296,61296,0.46948,43161,18135,2.379983457
4329,LP6005443-DNA_E08,18,36726,74078,74078,0.49577,50956,23122,2.2037886
4330,LP6005443-DNA_E08,19,22144,46265,46265,0.47863,32580,13685,2.380708805
4331,LP6005443-DNA_E08,2,105976,206659,206659,0.51281,140445,66214,2.121077114
4332,LP6005443-DNA_E08,20,24480,53498,53498,0.45759,37347,16151,2.312364559
4333,LP6005443-DNA_E08,21,17417,36440,36440,0.47796,24864,11576,2.147892191
4334,LP6005443-DNA_E08,22,14298,29062,29062,0.49198,20600,8462,2.434412668
4335,LP6005443-DNA_E08,3,95013,182341,182341,0.52107,123130,59211,2.079512253
4336,LP6005443-DNA_E08,4,92163,181079,181079,0.50897,122423,58656,2.087135161
4337,LP6005443-DNA_E08,5,72926,152050,152050,0.47962,102819,49231,2.088501148
4338,LP6005443-DNA_E08,6,78607,163205,163205,0.48165,111723,51482,2.170137135
4339,LP6005443-DNA_E08,7,66469,134358,134358,0.49472,91729,42629,2.151798072
4340,LP6005443-DNA_E08,8,69523,134450,134450,0.51709,89088,45362,1.963934571
4341,LP6005443-DNA_E08,9,52260,104311,104311,0.501,69897,34414,2.03106294
4342,LP6005443-DNA_E08,MT,46,48,48,0.95833,47,1,47
4343,LP6005443-DNA_E08,X,34874,69897,69897,0.49893,47101,22796,2.066195824
4344,LP6005443-DNA_E09,1,89148,201480,201480,0.44247,138971,62509,2.223215857
4345,LP6005443-DNA_E09,10,56203,129452,129452,0.43416,89062,40390,2.205050755
4346,LP6005443-DNA_E09,11,55795,131061,131061,0.42572,88988,42073,2.115085684
4347,LP6005443-DNA_E09,12,53610,123623,123623,0.43366,84871,38752,2.190106317
4348,LP6005443-DNA_E09,13,46929,102042,102042,0.4599,69528,32514,2.138401919
4349,LP6005443-DNA_E09,14,36290,84515,84515,0.42939,57737,26778,2.156135634
4350,LP6005443-DNA_E09,15,31115,73985,73985,0.42056,50438,23547,2.142013845
4351,LP6005443-DNA_E09,16,30770,74649,74649,0.4122,48757,25892,1.883091302
4352,LP6005443-DNA_E09,17,25111,61461,61461,0.40857,43389,18072,2.400896414
4353,LP6005443-DNA_E09,18,32607,78899,78899,0.41328,54036,24863,2.173349958
4354,LP6005443-DNA_E09,19,16772,45058,45058,0.37223,31679,13379,2.367815233
4355,LP6005443-DNA_E09,2,96142,217415,217415,0.4422,147700,69715,2.118625834
4356,LP6005443-DNA_E09,20,22066,55002,55002,0.40119,38337,16665,2.300450045
4357,LP6005443-DNA_E09,21,14627,33977,33977,0.4305,23127,10850,2.131520737
4358,LP6005443-DNA_E09,22,14063,30242,30242,0.46502,21450,8792,2.439717925
4359,LP6005443-DNA_E09,3,80941,186958,186958,0.43294,126490,60468,2.091850235
4360,LP6005443-DNA_E09,4,82844,191094,191094,0.43352,128986,62108,2.0768017
4361,LP6005443-DNA_E09,5,63657,156404,156404,0.407,105625,50779,2.080092164
4362,LP6005443-DNA_E09,6,70718,167968,167968,0.42102,115015,52953,2.172020471
4363,LP6005443-DNA_E09,7,57474,143093,143093,0.40165,97356,45737,2.128604849
4364,LP6005443-DNA_E09,8,58479,137028,137028,0.42677,90959,46069,1.974407953
4365,LP6005443-DNA_E09,9,44477,108101,108101,0.41144,72530,35571,2.03902055
4366,LP6005443-DNA_E09,MT,29,33,33,0.87879,31,2,15.5
4367,LP6005443-DNA_E09,X,51044,51805,51805,0.98531,34811,16994,2.048428857
4368,LP6005443-DNA_E09,Y,641,665,665,0.96391,430,235,1.829787234
4369,LP6005443-DNA_E10,1,78294,198385,198385,0.39466,136532,61853,2.207362618
4370,LP6005443-DNA_E10,10,49971,131210,131210,0.38085,90459,40751,2.219798287
4371,LP6005443-DNA_E10,11,55165,133814,133814,0.41225,91055,42759,2.129493206
4372,LP6005443-DNA_E10,12,46268,122818,122818,0.37672,84418,38400,2.198385417
4373,LP6005443-DNA_E10,13,42632,104444,104444,0.40818,71255,33189,2.146946277
4374,LP6005443-DNA_E10,14,34043,84002,84002,0.40526,57331,26671,2.149563196
4375,LP6005443-DNA_E10,15,30156,74879,74879,0.40273,50824,24055,2.112824777
4376,LP6005443-DNA_E10,16,30530,75802,75802,0.40276,49430,26372,1.874336417
4377,LP6005443-DNA_E10,17,24775,61818,61818,0.40077,43545,18273,2.383024134
4378,LP6005443-DNA_E10,18,31034,80027,80027,0.38779,54874,25153,2.181608556
4379,LP6005443-DNA_E10,19,15998,47533,47533,0.33657,33422,14111,2.368506839
4380,LP6005443-DNA_E10,2,86093,219377,219377,0.39244,148756,70621,2.106398946
4381,LP6005443-DNA_E10,20,18835,53340,53340,0.35311,37036,16304,2.271589794
4382,LP6005443-DNA_E10,21,14162,37608,37608,0.37657,25652,11956,2.145533623
4383,LP6005443-DNA_E10,22,10831,31866,31866,0.33989,22518,9348,2.40885751
4384,LP6005443-DNA_E10,3,68559,184289,184289,0.37202,124647,59642,2.089919855
4385,LP6005443-DNA_E10,4,79404,194457,194457,0.40834,131625,62832,2.09487204
4386,LP6005443-DNA_E10,5,62340,165342,165342,0.37704,111686,53656,2.081519308
4387,LP6005443-DNA_E10,6,61730,167007,167007,0.36963,114420,52587,2.175822922
4388,LP6005443-DNA_E10,7,54362,142230,142230,0.38221,96528,45702,2.112117632
4389,LP6005443-DNA_E10,8,53310,142911,142911,0.37303,94511,48400,1.952706612
4390,LP6005443-DNA_E10,9,41682,111555,111555,0.37365,74471,37084,2.00817064
4391,LP6005443-DNA_E10,MT,17,20,20,0.85,17,3,5.666666667
4392,LP6005443-DNA_E10,X,49842,50472,50472,0.98752,33931,16541,2.051327006
4393,LP6005443-DNA_E10,Y,717,796,796,0.90075,482,314,1.535031847
4394,LP6005443-DNA_E11,1,92351,189242,189242,0.488,130285,58957,2.209830894
4395,LP6005443-DNA_E11,10,55615,124917,124917,0.44522,85938,38979,2.204725621
4396,LP6005443-DNA_E11,11,60588,121073,121073,0.50043,82050,39023,2.102606155
4397,LP6005443-DNA_E11,12,54650,113079,113079,0.48329,77803,35276,2.205550516
4398,LP6005443-DNA_E11,13,49017,96838,96838,0.50618,66033,30805,2.143580588
4399,LP6005443-DNA_E11,14,39978,77977,77977,0.51269,53248,24729,2.153261353
4400,LP6005443-DNA_E11,15,35649,69196,69196,0.51519,47082,22114,2.129058515
4401,LP6005443-DNA_E11,16,33880,69463,69463,0.48774,45540,23923,1.903607407
4402,LP6005443-DNA_E11,17,27264,57408,57408,0.47492,40420,16988,2.379326583
4403,LP6005443-DNA_E11,18,34487,73018,73018,0.47231,50034,22984,2.176905674
4404,LP6005443-DNA_E11,19,17568,42545,42545,0.41293,29885,12660,2.360584518
4405,LP6005443-DNA_E11,2,101976,204658,204658,0.49828,139114,65544,2.122452093
4406,LP6005443-DNA_E11,20,23577,50287,50287,0.46885,35082,15205,2.307267346
4407,LP6005443-DNA_E11,21,14970,35969,35969,0.41619,24620,11349,2.169354128
4408,LP6005443-DNA_E11,22,13862,28231,28231,0.49102,19998,8233,2.429005223
4409,LP6005443-DNA_E11,3,83971,177336,177336,0.47351,119930,57406,2.089154444
4410,LP6005443-DNA_E11,4,88324,188942,188942,0.46747,127597,61345,2.079990219
4411,LP6005443-DNA_E11,5,69730,149737,149737,0.46568,100764,48973,2.057541911
4412,LP6005443-DNA_E11,6,75479,157942,157942,0.47789,108292,49650,2.181107754
4413,LP6005443-DNA_E11,7,66101,132887,132887,0.49742,90576,42311,2.140719907
4414,LP6005443-DNA_E11,8,60263,129789,129789,0.46432,86036,43753,1.966402304
4415,LP6005443-DNA_E11,9,48994,101877,101877,0.48091,68135,33742,2.019293462
4416,LP6005443-DNA_E11,MT,38,40,40,0.95,38,2,19
4417,LP6005443-DNA_E11,X,33723,67888,67888,0.49674,45745,22143,2.065889897
4418,LP6005443-DNA_F01,1,87141,191074,191074,0.45606,131483,59591,2.206423789
4419,LP6005443-DNA_F01,10,56203,124062,124062,0.45302,85560,38502,2.222222222
4420,LP6005443-DNA_F01,11,55527,121998,121998,0.45515,82611,39387,2.09741793
4421,LP6005443-DNA_F01,12,52265,117750,117750,0.44386,81030,36720,2.206699346
4422,LP6005443-DNA_F01,13,45452,97895,97895,0.46429,66587,31308,2.126836591
4423,LP6005443-DNA_F01,14,36433,81028,81028,0.44963,55377,25651,2.158863202
4424,LP6005443-DNA_F01,15,30923,71394,71394,0.43313,48693,22701,2.144971587
4425,LP6005443-DNA_F01,16,30704,71951,71951,0.42673,47176,24775,1.904177598
4426,LP6005443-DNA_F01,17,24577,59567,59567,0.41259,42070,17497,2.404412185
4427,LP6005443-DNA_F01,18,32495,73815,73815,0.44022,50578,23237,2.176614881
4428,LP6005443-DNA_F01,19,16266,40610,40610,0.40054,28493,12117,2.351489643
4429,LP6005443-DNA_F01,2,96502,209042,209042,0.46164,141875,67167,2.112272396
4430,LP6005443-DNA_F01,20,22387,52107,52107,0.42964,36395,15712,2.316382383
4431,LP6005443-DNA_F01,21,15490,35106,35106,0.44124,23971,11135,2.152761563
4432,LP6005443-DNA_F01,22,11334,28049,28049,0.40408,19856,8193,2.423532284
4433,LP6005443-DNA_F01,3,77319,182670,182670,0.42327,123480,59190,2.086163203
4434,LP6005443-DNA_F01,4,85841,187377,187377,0.45812,126499,60878,2.077909918
4435,LP6005443-DNA_F01,5,62348,152651,152651,0.40843,103059,49592,2.078137603
4436,LP6005443-DNA_F01,6,67164,165660,165660,0.40543,113541,52119,2.178495366
4437,LP6005443-DNA_F01,7,57636,139258,139258,0.41388,94825,44433,2.134112034
4438,LP6005443-DNA_F01,8,56228,135807,135807,0.41403,89864,45943,1.955988943
4439,LP6005443-DNA_F01,9,48270,101757,101757,0.47437,67739,34018,1.991269328
4440,LP6005443-DNA_F01,MT,42,46,46,0.91304,43,3,14.33333333
4441,LP6005443-DNA_F01,X,51544,52258,52258,0.98634,35274,16984,2.076895902
4442,LP6005443-DNA_F01,Y,654,675,675,0.96889,418,257,1.626459144
4443,LP6005443-DNA_F02,1,79986,240540,240540,0.33253,165849,74691,2.22046833
4444,LP6005443-DNA_F02,10,52009,158694,158694,0.32773,108866,49828,2.184835835
4445,LP6005443-DNA_F02,11,49660,152168,152168,0.32635,103481,48687,2.125433894
4446,LP6005443-DNA_F02,12,47921,140552,140552,0.34095,96658,43894,2.202077733
4447,LP6005443-DNA_F02,13,38128,118680,118680,0.32127,80849,37831,2.137109778
4448,LP6005443-DNA_F02,14,32728,100960,100960,0.32417,69224,31736,2.181245274
4449,LP6005443-DNA_F02,15,30933,89958,89958,0.34386,61192,28766,2.12723354
4450,LP6005443-DNA_F02,16,30135,94923,94923,0.31747,62284,32639,1.908269248
4451,LP6005443-DNA_F02,17,25359,75555,75555,0.33564,53131,22424,2.36938102
4452,LP6005443-DNA_F02,18,29775,94945,94945,0.3136,65060,29885,2.177011879
4453,LP6005443-DNA_F02,19,17574,54794,54794,0.32073,38616,16178,2.386945234
4454,LP6005443-DNA_F02,2,89028,263737,263737,0.33756,179022,84715,2.113226701
4455,LP6005443-DNA_F02,20,23229,67438,67438,0.34445,47202,20236,2.332575608
4456,LP6005443-DNA_F02,21,15642,46337,46337,0.33757,31677,14660,2.160777626
4457,LP6005443-DNA_F02,22,12252,37182,37182,0.32951,26344,10838,2.430706772
4458,LP6005443-DNA_F02,3,79043,236025,236025,0.33489,159885,76140,2.099881797
4459,LP6005443-DNA_F02,4,80858,239862,239862,0.3371,161963,77899,2.079140939
4460,LP6005443-DNA_F02,5,66430,208814,208814,0.31813,141346,67468,2.095008004
4461,LP6005443-DNA_F02,6,66579,207475,207475,0.3209,142046,65429,2.170994513
4462,LP6005443-DNA_F02,7,61778,179791,179791,0.34361,121799,57992,2.100272451
4463,LP6005443-DNA_F02,8,59489,185810,185810,0.32016,123365,62445,1.975578509
4464,LP6005443-DNA_F02,9,44046,134167,134167,0.32829,89488,44679,2.002909644
4465,LP6005443-DNA_F02,MT,85,89,89,0.95506,84,5,16.8
4466,LP6005443-DNA_F02,X,78956,81454,81454,0.96933,54838,26616,2.060339645
4467,LP6005443-DNA_F02,Y,954,1093,1093,0.87283,703,390,1.802564103
4468,LP6005443-DNA_F03,1,89592,189718,189718,0.47224,130234,59484,2.189395468
4469,LP6005443-DNA_F03,10,55914,124495,124495,0.44913,85596,38899,2.200467878
4470,LP6005443-DNA_F03,11,59562,117823,117823,0.50552,79716,38107,2.091899126
4471,LP6005443-DNA_F03,12,52142,117942,117942,0.4421,80757,37185,2.171762808
4472,LP6005443-DNA_F03,13,50453,97780,97780,0.51598,66547,31233,2.130663081
4473,LP6005443-DNA_F03,14,36467,82735,82735,0.44077,56350,26385,2.135683153
4474,LP6005443-DNA_F03,15,32112,69560,69560,0.46164,47304,22256,2.125449317
4475,LP6005443-DNA_F03,16,30785,66013,66013,0.46635,43251,22762,1.900140585
4476,LP6005443-DNA_F03,17,22862,52232,52232,0.4377,36680,15552,2.358539095
4477,LP6005443-DNA_F03,18,40116,71222,71222,0.56325,48504,22718,2.135047099
4478,LP6005443-DNA_F03,19,13051,33736,33736,0.38686,23550,10186,2.311996858
4479,LP6005443-DNA_F03,2,101091,207945,207945,0.48614,141048,66897,2.108435356
4480,LP6005443-DNA_F03,20,22554,49569,49569,0.455,34499,15070,2.289250166
4481,LP6005443-DNA_F03,21,15851,34739,34739,0.45629,23640,11099,2.129921615
4482,LP6005443-DNA_F03,22,9606,25390,25390,0.37834,17915,7475,2.396655518
4483,LP6005443-DNA_F03,3,83875,182744,182744,0.45898,123094,59650,2.063604359
4484,LP6005443-DNA_F03,4,86377,195509,195509,0.44181,131962,63547,2.076604718
4485,LP6005443-DNA_F03,5,66468,155389,155389,0.42775,104555,50834,2.056792698
4486,LP6005443-DNA_F03,6,70455,162268,162268,0.43419,110715,51553,2.147595678
4487,LP6005443-DNA_F03,7,59522,137229,137229,0.43374,93006,44223,2.103113764
4488,LP6005443-DNA_F03,8,65398,133679,133679,0.48922,88399,45280,1.952274735
4489,LP6005443-DNA_F03,9,45273,100299,100299,0.45138,67079,33220,2.0192354
4490,LP6005443-DNA_F03,MT,30,32,32,0.9375,NA,NA,NA
4491,LP6005443-DNA_F03,X,34199,71378,71378,0.47913,48108,23270,2.067382896
4492,LP6005443-DNA_F04,1,85160,209867,209867,0.40578,144563,65304,2.213692883
4493,LP6005443-DNA_F04,10,54913,136248,136248,0.40304,93720,42528,2.203724605
4494,LP6005443-DNA_F04,11,54692,133573,133573,0.40945,90706,42867,2.115986656
4495,LP6005443-DNA_F04,12,54114,124959,124959,0.43305,85878,39081,2.197436094
4496,LP6005443-DNA_F04,13,48623,105303,105303,0.46174,71823,33480,2.145250896
4497,LP6005443-DNA_F04,14,34113,87864,87864,0.38825,59925,27939,2.144851283
4498,LP6005443-DNA_F04,15,31625,76280,76280,0.41459,51950,24330,2.135224003
4499,LP6005443-DNA_F04,16,31708,77866,77866,0.40721,51025,26841,1.901009649
4500,LP6005443-DNA_F04,17,24199,61012,61012,0.39663,43163,17849,2.418230713
4501,LP6005443-DNA_F04,18,34534,80157,80157,0.43083,55000,25157,2.186270223
4502,LP6005443-DNA_F04,19,16834,45384,45384,0.37092,31802,13582,2.341481372
4503,LP6005443-DNA_F04,2,92179,228956,228956,0.40261,155538,73418,2.118526792
4504,LP6005443-DNA_F04,20,19717,55415,55415,0.35581,38675,16740,2.310334528
4505,LP6005443-DNA_F04,21,15105,38431,38431,0.39304,26258,12173,2.157068923
4506,LP6005443-DNA_F04,22,10844,31499,31499,0.34426,22227,9272,2.397217429
4507,LP6005443-DNA_F04,3,76451,192739,192739,0.39666,130163,62576,2.080078624
4508,LP6005443-DNA_F04,4,89799,206167,206167,0.43556,139411,66756,2.088366589
4509,LP6005443-DNA_F04,5,64020,168780,168780,0.37931,114174,54606,2.090869135
4510,LP6005443-DNA_F04,6,64782,177165,177165,0.36566,121406,55759,2.177334601
4511,LP6005443-DNA_F04,7,61467,149258,149258,0.41182,101533,47725,2.127459403
4512,LP6005443-DNA_F04,8,55784,150987,150987,0.36946,100112,50875,1.96780344
4513,LP6005443-DNA_F04,9,45615,112155,112155,0.40671,74922,37233,2.0122472
4514,LP6005443-DNA_F04,MT,30,31,31,0.96774,30,1,30
4515,LP6005443-DNA_F04,X,4149,5431,5431,0.76395,3700,1731,2.137492779
4516,LP6005443-DNA_F06,1,77509,228125,228125,0.33977,157388,70737,2.2249742
4517,LP6005443-DNA_F06,10,51144,148141,148141,0.34524,101892,46249,2.203117905
4518,LP6005443-DNA_F06,11,50663,147719,147719,0.34297,100445,47274,2.124740872
4519,LP6005443-DNA_F06,12,45458,142245,142245,0.31958,97698,44547,2.193144319
4520,LP6005443-DNA_F06,13,40729,111400,111400,0.36561,76038,35362,2.150274306
4521,LP6005443-DNA_F06,14,33372,99060,99060,0.33689,67760,31300,2.16485623
4522,LP6005443-DNA_F06,15,28061,89120,89120,0.31487,60584,28536,2.12307261
4523,LP6005443-DNA_F06,16,29614,89148,89148,0.33219,58456,30692,1.904600547
4524,LP6005443-DNA_F06,17,24554,74042,74042,0.33162,52270,21772,2.400790006
4525,LP6005443-DNA_F06,18,29987,88332,88332,0.33948,60395,27937,2.1618284
4526,LP6005443-DNA_F06,19,16446,54246,54246,0.30317,38350,15896,2.412556618
4527,LP6005443-DNA_F06,2,84625,253919,253919,0.33328,172587,81332,2.122006098
4528,LP6005443-DNA_F06,20,20621,65552,65552,0.31457,45833,19719,2.324306506
4529,LP6005443-DNA_F06,21,14959,43583,43583,0.34323,29749,13834,2.150426485
4530,LP6005443-DNA_F06,22,12426,36789,36789,0.33776,26073,10716,2.433090705
4531,LP6005443-DNA_F06,3,70421,227622,227622,0.30938,154169,73453,2.098879556
4532,LP6005443-DNA_F06,4,73832,224420,224420,0.32899,151681,72739,2.085277499
4533,LP6005443-DNA_F06,5,61723,194426,194426,0.31746,131464,62962,2.087989581
4534,LP6005443-DNA_F06,6,67221,191768,191768,0.35053,131299,60469,2.171343994
4535,LP6005443-DNA_F06,7,58607,174202,174202,0.33643,118123,56079,2.106367803
4536,LP6005443-DNA_F06,8,54771,170507,170507,0.32122,113075,57432,1.968850118
4537,LP6005443-DNA_F06,9,40952,127171,127171,0.32202,84884,42287,2.007330858
4538,LP6005443-DNA_F06,MT,38,41,41,0.92683,40,1,40
4539,LP6005443-DNA_F06,X,71892,72947,72947,0.98554,49127,23820,2.062426532
4540,LP6005443-DNA_F06,Y,971,1017,1017,0.95477,641,376,1.704787234
4541,LP6005443-DNA_F07,1,96016,187588,187588,0.51185,129476,58112,2.228042401
4542,LP6005443-DNA_F07,10,59712,121817,121817,0.49018,83801,38016,2.204361322
4543,LP6005443-DNA_F07,11,65075,121151,121151,0.53714,82240,38911,2.113541158
4544,LP6005443-DNA_F07,12,60673,118034,118034,0.51403,80930,37104,2.181166451
4545,LP6005443-DNA_F07,13,49849,94290,94290,0.52868,64277,30013,2.141638623
4546,LP6005443-DNA_F07,14,44378,75203,75203,0.59011,51463,23740,2.167775906
4547,LP6005443-DNA_F07,15,35548,73777,73777,0.48183,50254,23523,2.136377163
4548,LP6005443-DNA_F07,16,34592,71928,71928,0.48093,47213,24715,1.91029739
4549,LP6005443-DNA_F07,17,29888,58558,58558,0.5104,41059,17499,2.346362649
4550,LP6005443-DNA_F07,18,37496,72457,72457,0.51749,49523,22934,2.159370367
4551,LP6005443-DNA_F07,19,20876,45861,45861,0.4552,32260,13601,2.37188442
4552,LP6005443-DNA_F07,2,106177,202109,202109,0.52535,137086,65023,2.108269382
4553,LP6005443-DNA_F07,20,26388,52027,52027,0.5072,36334,15693,2.315299815
4554,LP6005443-DNA_F07,21,17435,36934,36934,0.47206,25147,11787,2.133452108
4555,LP6005443-DNA_F07,22,13819,26994,26994,0.51193,19136,7858,2.435225248
4556,LP6005443-DNA_F07,3,88843,184411,184411,0.48177,124617,59794,2.084105429
4557,LP6005443-DNA_F07,4,96649,176192,176192,0.54854,119168,57024,2.089786756
4558,LP6005443-DNA_F07,5,72167,155331,155331,0.4646,104991,50340,2.085637664
4559,LP6005443-DNA_F07,6,77696,160745,160745,0.48335,110075,50670,2.172389974
4560,LP6005443-DNA_F07,7,63592,131791,131791,0.48252,89934,41857,2.14860119
4561,LP6005443-DNA_F07,8,67340,131919,131919,0.51046,87558,44361,1.973760736
4562,LP6005443-DNA_F07,9,50267,104882,104882,0.47927,70080,34802,2.013677375
4563,LP6005443-DNA_F07,MT,26,27,27,0.96296,26,1,26
4564,LP6005443-DNA_F07,X,55117,55877,55877,0.9864,37638,18239,2.063599978
4565,LP6005443-DNA_F07,Y,672,696,696,0.96552,450,246,1.829268293
4566,LP6005443-DNA_F08,1,96593,193895,193895,0.49817,133816,60079,2.22733401
4567,LP6005443-DNA_F08,10,60946,121342,121342,0.50227,83551,37791,2.210870313
4568,LP6005443-DNA_F08,11,64108,119052,119052,0.53849,80851,38201,2.11646292
4569,LP6005443-DNA_F08,12,58277,117886,117886,0.49435,80975,36911,2.193790469
4570,LP6005443-DNA_F08,13,52176,95126,95126,0.54849,64684,30442,2.124827541
4571,LP6005443-DNA_F08,14,40657,81667,81667,0.49784,55911,25756,2.170795155
4572,LP6005443-DNA_F08,15,33743,71377,71377,0.47274,48577,22800,2.130570175
4573,LP6005443-DNA_F08,16,34351,73175,73175,0.46944,48275,24900,1.93875502
4574,LP6005443-DNA_F08,17,28676,60825,60825,0.47145,42760,18065,2.367008027
4575,LP6005443-DNA_F08,18,38538,73291,73291,0.52582,50134,23157,2.164960919
4576,LP6005443-DNA_F08,19,21349,46605,46605,0.45808,32938,13667,2.41003878
4577,LP6005443-DNA_F08,2,103696,202923,202923,0.51101,137717,65206,2.112029568
4578,LP6005443-DNA_F08,20,25862,54486,54486,0.47465,38039,16447,2.312823007
4579,LP6005443-DNA_F08,21,16769,35852,35852,0.46773,24461,11391,2.147397068
4580,LP6005443-DNA_F08,22,14743,28203,28203,0.52275,19931,8272,2.409453578
4581,LP6005443-DNA_F08,3,87273,187217,187217,0.46616,126663,60554,2.091736301
4582,LP6005443-DNA_F08,4,92758,183175,183175,0.50639,123993,59182,2.095113379
4583,LP6005443-DNA_F08,5,72996,156847,156847,0.4654,105849,50998,2.075551982
4584,LP6005443-DNA_F08,6,75084,165937,165937,0.45248,113593,52344,2.170124561
4585,LP6005443-DNA_F08,7,63885,134323,134323,0.47561,91578,42745,2.142426015
4586,LP6005443-DNA_F08,8,66139,132586,132586,0.49884,87956,44630,1.970781985
4587,LP6005443-DNA_F08,9,55475,103868,103868,0.53409,69530,34338,2.024870406
4588,LP6005443-DNA_F08,MT,33,40,40,0.825,NA,NA,NA
4589,LP6005443-DNA_F08,X,54270,54976,54976,0.98716,37010,17966,2.060002226
4590,LP6005443-DNA_F08,Y,653,672,672,0.97173,422,250,1.688
4591,LP6005443-DNA_F10,1,79979,192950,192950,0.41451,132770,60180,2.206214689
4592,LP6005443-DNA_F10,10,48997,126607,126607,0.387,86671,39936,2.170247396
4593,LP6005443-DNA_F10,11,52049,125078,125078,0.41613,84808,40270,2.105984604
4594,LP6005443-DNA_F10,12,46938,119543,119543,0.39265,81985,37558,2.182890463
4595,LP6005443-DNA_F10,13,43766,104653,104653,0.4182,71034,33619,2.112912341
4596,LP6005443-DNA_F10,14,34880,82897,82897,0.42076,56472,26425,2.137067171
4597,LP6005443-DNA_F10,15,28689,72599,72599,0.39517,49295,23304,2.115302094
4598,LP6005443-DNA_F10,16,27838,73493,73493,0.37878,48090,25403,1.893083494
4599,LP6005443-DNA_F10,17,22027,58230,58230,0.37828,41071,17159,2.393554403
4600,LP6005443-DNA_F10,18,32342,77471,77471,0.41747,52971,24500,2.162081633
4601,LP6005443-DNA_F10,19,16220,43839,43839,0.36999,30757,13082,2.351093105
4602,LP6005443-DNA_F10,2,84966,210599,210599,0.40345,142731,67868,2.10306772
4603,LP6005443-DNA_F10,20,19972,53320,53320,0.37457,37180,16140,2.303593556
4604,LP6005443-DNA_F10,21,15327,35621,35621,0.43028,24132,11489,2.100443903
4605,LP6005443-DNA_F10,22,10450,27625,27625,0.37828,19526,8099,2.410914928
4606,LP6005443-DNA_F10,3,71902,191093,191093,0.37627,128840,62253,2.069619135
4607,LP6005443-DNA_F10,4,78146,198750,198750,0.39319,134275,64475,2.082590151
4608,LP6005443-DNA_F10,5,61147,162092,162092,0.37724,109248,52844,2.067368102
4609,LP6005443-DNA_F10,6,63834,165342,165342,0.38607,113109,52233,2.165470105
4610,LP6005443-DNA_F10,7,52887,145198,145198,0.36424,98595,46603,2.115636332
4611,LP6005443-DNA_F10,8,54966,141552,141552,0.38831,93385,48167,1.93877551
4612,LP6005443-DNA_F10,9,40891,107762,107762,0.37946,71895,35867,2.004488806
4613,LP6005443-DNA_F10,MT,16,19,19,0.84211,18,1,18
4614,LP6005443-DNA_F10,X,49260,49777,49777,0.98961,33409,16368,2.041116813
4615,LP6005443-DNA_F10,Y,701,777,777,0.90219,464,313,1.482428115
4616,LP6005443-DNA_G01,1,88611,196261,196261,0.4515,135211,61050,2.214758395
4617,LP6005443-DNA_G01,10,54033,127288,127288,0.42449,87472,39816,2.196905767
4618,LP6005443-DNA_G01,11,56055,126473,126473,0.44322,85716,40757,2.103098854
4619,LP6005443-DNA_G01,12,3386,6440,6440,0.52578,4511,1929,2.338517367
4620,LP6005443-DNA_G01,13,45362,102986,102986,0.44047,70041,32945,2.125997875
4621,LP6005443-DNA_G01,14,35618,81643,81643,0.43627,55639,26004,2.139632364
4622,LP6005443-DNA_G01,15,33023,73011,73011,0.4523,49553,23458,2.112413676
4623,LP6005443-DNA_G01,16,30994,73073,73073,0.42415,47891,25182,1.901794933
4624,LP6005443-DNA_G01,17,24645,59784,59784,0.41223,41985,17799,2.358840384
4625,LP6005443-DNA_G01,18,32534,77655,77655,0.41896,53164,24491,2.170756604
4626,LP6005443-DNA_G01,19,15690,41198,41198,0.38084,28995,12203,2.376055068
4627,LP6005443-DNA_G01,2,93817,208179,208179,0.45066,141085,67094,2.102796077
4628,LP6005443-DNA_G01,20,21243,55259,55259,0.38443,38521,16738,2.301409965
4629,LP6005443-DNA_G01,21,15617,34875,34875,0.4478,23728,11147,2.128644478
4630,LP6005443-DNA_G01,22,11154,27781,27781,0.4015,19570,8211,2.383388138
4631,LP6005443-DNA_G01,3,78160,180448,180448,0.43314,121727,58721,2.072972191
4632,LP6005443-DNA_G01,4,86574,193647,193647,0.44707,130685,62962,2.075617039
4633,LP6005443-DNA_G01,5,62337,154662,154662,0.40305,104126,50536,2.060432167
4634,LP6005443-DNA_G01,6,70790,165341,165341,0.42815,113274,52067,2.17554305
4635,LP6005443-DNA_G01,7,58898,139055,139055,0.42356,94511,44544,2.121744792
4636,LP6005443-DNA_G01,8,60339,138362,138362,0.4361,91558,46804,1.956200325
4637,LP6005443-DNA_G01,9,46605,106298,106298,0.43844,71060,35238,2.016573018
4638,LP6005443-DNA_G01,MT,47,49,49,0.95918,48,1,48
4639,LP6005443-DNA_G01,X,32020,71428,71428,0.44828,48196,23232,2.074552342
4640,LP6005443-DNA_G02,1,78225,244432,244432,0.32003,168502,75930,2.219175556
4641,LP6005443-DNA_G02,10,54281,155067,155067,0.35005,106737,48330,2.208504035
4642,LP6005443-DNA_G02,11,52547,156015,156015,0.33681,105928,50087,2.114880109
4643,LP6005443-DNA_G02,12,49219,147991,147991,0.33258,101738,46253,2.199597864
4644,LP6005443-DNA_G02,13,39850,121843,121843,0.32706,83012,38831,2.137776519
4645,LP6005443-DNA_G02,14,33910,104829,104829,0.32348,71670,33159,2.161404144
4646,LP6005443-DNA_G02,15,31769,94552,94552,0.336,64206,30346,2.115797799
4647,LP6005443-DNA_G02,16,31705,94694,94694,0.33482,62126,32568,1.907577991
4648,LP6005443-DNA_G02,17,24641,78752,78752,0.31289,55415,23337,2.374555427
4649,LP6005443-DNA_G02,18,30998,93108,93108,0.33293,63720,29388,2.168231931
4650,LP6005443-DNA_G02,19,20050,57566,57566,0.3483,40847,16719,2.443148514
4651,LP6005443-DNA_G02,2,93369,269863,269863,0.34599,183143,86720,2.111888838
4652,LP6005443-DNA_G02,20,23037,72280,72280,0.31872,50524,21756,2.322301894
4653,LP6005443-DNA_G02,21,16152,47823,47823,0.33775,32760,15063,2.174865565
4654,LP6005443-DNA_G02,22,11999,38611,38611,0.31077,27512,11099,2.478781872
4655,LP6005443-DNA_G02,3,83921,240345,240345,0.34917,162468,77877,2.086212874
4656,LP6005443-DNA_G02,4,80179,240218,240218,0.33378,162486,77732,2.090336026
4657,LP6005443-DNA_G02,5,71706,212940,212940,0.33674,143699,69241,2.075345532
4658,LP6005443-DNA_G02,6,71508,215834,215834,0.33131,147770,68064,2.171044899
4659,LP6005443-DNA_G02,7,62571,184117,184117,0.33984,124779,59338,2.102851461
4660,LP6005443-DNA_G02,8,62063,187997,187997,0.33013,124507,63490,1.961048984
4661,LP6005443-DNA_G02,9,44685,142444,142444,0.3137,94953,47491,1.999389358
4662,LP6005443-DNA_G02,MT,89,91,91,0.97802,87,4,21.75
4663,LP6005443-DNA_G02,X,74213,77505,77505,0.95753,52309,25196,2.076083505
4664,LP6005443-DNA_G02,Y,960,1162,1162,0.82616,760,402,1.890547264
4665,LP6005443-DNA_G03,1,87995,196664,196664,0.44744,135259,61405,2.202735934
4666,LP6005443-DNA_G03,10,62557,121938,121938,0.51302,83987,37951,2.213037865
4667,LP6005443-DNA_G03,11,61024,120584,120584,0.50607,81636,38948,2.09602547
4668,LP6005443-DNA_G03,12,53723,118660,118660,0.45275,81545,37115,2.197090125
4669,LP6005443-DNA_G03,13,55808,96658,96658,0.57738,65749,30909,2.127179786
4670,LP6005443-DNA_G03,14,35648,81952,81952,0.43499,55771,26181,2.13020893
4671,LP6005443-DNA_G03,15,31402,72859,72859,0.431,49436,23423,2.110575076
4672,LP6005443-DNA_G03,16,31685,71121,71121,0.44551,46608,24513,1.901358463
4673,LP6005443-DNA_G03,17,26216,55180,55180,0.4751,38835,16345,2.37595595
4674,LP6005443-DNA_G03,18,36377,77503,77503,0.46936,52926,24577,2.153476828
4675,LP6005443-DNA_G03,19,16270,35939,35939,0.45271,25203,10736,2.347522355
4676,LP6005443-DNA_G03,2,98402,215304,215304,0.45704,146035,69269,2.108230233
4677,LP6005443-DNA_G03,20,21738,52035,52035,0.41776,36412,15623,2.330666325
4678,LP6005443-DNA_G03,21,15685,35209,35209,0.44548,24049,11160,2.154928315
4679,LP6005443-DNA_G03,22,11187,27904,27904,0.40091,19800,8104,2.443237907
4680,LP6005443-DNA_G03,3,85861,183480,183480,0.46796,123634,59846,2.065869064
4681,LP6005443-DNA_G03,4,92258,191583,191583,0.48156,129235,62348,2.072801052
4682,LP6005443-DNA_G03,5,66846,156780,156780,0.42637,105547,51233,2.060137021
4683,LP6005443-DNA_G03,6,73153,161182,161182,0.45385,110540,50642,2.182773192
4684,LP6005443-DNA_G03,7,63924,136903,136903,0.46693,93164,43739,2.1299984
4685,LP6005443-DNA_G03,8,63088,133907,133907,0.47113,88854,45053,1.972210508
4686,LP6005443-DNA_G03,9,49488,106818,106818,0.46329,71184,35634,1.997642701
4687,LP6005443-DNA_G03,MT,31,33,33,0.93939,NA,NA,NA
4688,LP6005443-DNA_G03,X,33652,70451,70451,0.47767,47481,22970,2.067087505
4689,LP6005443-DNA_G04,1,80667,193498,193498,0.41689,133418,60080,2.220672437
4690,LP6005443-DNA_G04,10,50784,123358,123358,0.41168,85049,38309,2.220078833
4691,LP6005443-DNA_G04,11,51567,129203,129203,0.39912,87523,41680,2.099880038
4692,LP6005443-DNA_G04,12,46174,117471,117471,0.39307,80562,36909,2.182719662
4693,LP6005443-DNA_G04,13,44628,105923,105923,0.42132,72173,33750,2.138459259
4694,LP6005443-DNA_G04,14,34080,82465,82465,0.41327,56319,26146,2.154019735
4695,LP6005443-DNA_G04,15,28465,71004,71004,0.40089,48398,22606,2.140936035
4696,LP6005443-DNA_G04,16,27361,71548,71548,0.38241,46702,24846,1.879658698
4697,LP6005443-DNA_G04,17,21402,56202,56202,0.3808,39751,16451,2.416327275
4698,LP6005443-DNA_G04,18,31011,78836,78836,0.39336,54060,24776,2.181950274
4699,LP6005443-DNA_G04,19,14512,40224,40224,0.36078,28366,11858,2.392140327
4700,LP6005443-DNA_G04,2,86524,214122,214122,0.40409,145452,68670,2.118130188
4701,LP6005443-DNA_G04,20,19649,51159,51159,0.38408,35680,15479,2.305058466
4702,LP6005443-DNA_G04,21,13838,35718,35718,0.38742,24307,11411,2.130137587
4703,LP6005443-DNA_G04,22,9640,25754,25754,0.37431,18164,7590,2.39314888
4704,LP6005443-DNA_G04,3,75669,185069,185069,0.40887,124943,60126,2.078019492
4705,LP6005443-DNA_G04,4,79191,195136,195136,0.40582,131915,63221,2.086569336
4706,LP6005443-DNA_G04,5,61318,160776,160776,0.38139,108364,52412,2.067541784
4707,LP6005443-DNA_G04,6,62878,165932,165932,0.37894,113589,52343,2.170089601
4708,LP6005443-DNA_G04,7,51246,140163,140163,0.36562,95451,44712,2.134796028
4709,LP6005443-DNA_G04,8,56448,135869,135869,0.41546,89618,46251,1.937644591
4710,LP6005443-DNA_G04,9,39842,104866,104866,0.37993,70101,34765,2.016424565
4711,LP6005443-DNA_G04,MT,33,34,34,0.97059,NA,NA,NA
4712,LP6005443-DNA_G04,X,27647,74410,74410,0.37155,50175,24235,2.070352796
4713,LP6005443-DNA_G05,1,90385,193324,193324,0.46753,132829,60495,2.195702124
4714,LP6005443-DNA_G05,10,57807,126615,126615,0.45656,86854,39761,2.184401801
4715,LP6005443-DNA_G05,11,58520,121264,121264,0.48258,82265,38999,2.109413062
4716,LP6005443-DNA_G05,12,53757,119965,119965,0.44811,82258,37707,2.18150476
4717,LP6005443-DNA_G05,13,47325,100110,100110,0.47273,68113,31997,2.128730819
4718,LP6005443-DNA_G05,14,36670,83821,83821,0.43748,57247,26574,2.154248514
4719,LP6005443-DNA_G05,15,32959,72079,72079,0.45726,49110,22969,2.138099177
4720,LP6005443-DNA_G05,16,32051,74775,74775,0.42863,48996,25779,1.900616781
4721,LP6005443-DNA_G05,17,25352,59487,59487,0.42618,41926,17561,2.387449462
4722,LP6005443-DNA_G05,18,33896,74602,74602,0.45436,51245,23357,2.193988954
4723,LP6005443-DNA_G05,19,17296,40334,40334,0.42882,28416,11918,2.384292667
4724,LP6005443-DNA_G05,2,98003,207238,207238,0.4729,140399,66839,2.100555065
4725,LP6005443-DNA_G05,20,22854,53420,53420,0.42782,37264,16156,2.306511513
4726,LP6005443-DNA_G05,21,15500,34867,34867,0.44455,23667,11200,2.113125
4727,LP6005443-DNA_G05,22,11434,27771,27771,0.41172,19657,8114,2.422602909
4728,LP6005443-DNA_G05,3,82319,182050,182050,0.45218,123104,58946,2.08841991
4729,LP6005443-DNA_G05,4,87619,191032,191032,0.45866,128942,62090,2.07669512
4730,LP6005443-DNA_G05,5,65740,151049,151049,0.43522,101896,49153,2.073037251
4731,LP6005443-DNA_G05,6,76686,162570,162570,0.47171,111186,51384,2.163825315
4732,LP6005443-DNA_G05,7,59110,139399,139399,0.42403,94836,44563,2.128133205
4733,LP6005443-DNA_G05,8,56684,136128,136128,0.4164,89752,46376,1.935311368
4734,LP6005443-DNA_G05,9,49563,105615,105615,0.46928,70598,35017,2.016106463
4735,LP6005443-DNA_G05,MT,24,31,31,0.77419,27,4,6.75
4736,LP6005443-DNA_G05,X,51280,52110,52110,0.98407,35034,17076,2.051651441
4737,LP6005443-DNA_G05,Y,612,636,636,0.96226,409,227,1.801762115
4738,LP6005443-DNA_G07,1,96992,188788,188788,0.51376,130177,58611,2.221033594
4739,LP6005443-DNA_G07,10,60918,118093,118093,0.51585,81256,36837,2.205825664
4740,LP6005443-DNA_G07,11,61594,122296,122296,0.50365,83002,39294,2.112332672
4741,LP6005443-DNA_G07,12,61370,116640,116640,0.52615,80028,36612,2.185840708
4742,LP6005443-DNA_G07,13,49287,92654,92654,0.53195,63174,29480,2.142944369
4743,LP6005443-DNA_G07,14,41202,83331,83331,0.49444,57025,26306,2.167756405
4744,LP6005443-DNA_G07,15,35782,73329,73329,0.48797,49879,23450,2.127036247
4745,LP6005443-DNA_G07,16,37337,71884,71884,0.51941,47286,24598,1.922351411
4746,LP6005443-DNA_G07,17,29003,61005,61005,0.47542,42893,18112,2.368208922
4747,LP6005443-DNA_G07,18,36943,74046,74046,0.49892,50730,23316,2.175759135
4748,LP6005443-DNA_G07,19,19755,45326,45326,0.43584,31875,13451,2.369712289
4749,LP6005443-DNA_G07,2,106320,202987,202987,0.52378,137548,65439,2.101926985
4750,LP6005443-DNA_G07,20,26089,50465,50465,0.51697,35134,15331,2.291696563
4751,LP6005443-DNA_G07,21,17583,34980,34980,0.50266,23943,11037,2.169339494
4752,LP6005443-DNA_G07,22,14590,28315,28315,0.51527,20184,8131,2.482351494
4753,LP6005443-DNA_G07,3,88137,184493,184493,0.47773,124775,59718,2.08940353
4754,LP6005443-DNA_G07,4,89578,180057,180057,0.4975,121868,58189,2.094347729
4755,LP6005443-DNA_G07,5,73763,152707,152707,0.48304,103029,49678,2.073936149
4756,LP6005443-DNA_G07,6,77857,160140,160140,0.48618,109474,50666,2.160699483
4757,LP6005443-DNA_G07,7,63421,134382,134382,0.47195,91461,42921,2.130914937
4758,LP6005443-DNA_G07,8,69785,131943,131943,0.5289,87720,44223,1.983583203
4759,LP6005443-DNA_G07,9,52845,101715,101715,0.51954,67790,33925,1.998231393
4760,LP6005443-DNA_G07,MT,53,55,55,0.96364,53,2,26.5
4761,LP6005443-DNA_G07,X,53189,53835,53835,0.988,36199,17636,2.052562939
4762,LP6005443-DNA_G07,Y,660,685,685,0.9635,437,248,1.762096774
4763,LP6005443-DNA_G08,1,94948,258672,258672,0.36706,178603,80069,2.230613596
4764,LP6005443-DNA_G08,10,59488,166770,166770,0.35671,114616,52154,2.197645435
4765,LP6005443-DNA_G08,11,58610,163368,163368,0.35876,111342,52026,2.140122247
4766,LP6005443-DNA_G08,12,59825,152501,152501,0.39229,104813,47688,2.197890455
4767,LP6005443-DNA_G08,13,47174,123078,123078,0.38329,83842,39236,2.136864104
4768,LP6005443-DNA_G08,14,42520,109810,109810,0.38721,75250,34560,2.177372685
4769,LP6005443-DNA_G08,15,37751,95914,95914,0.39359,65295,30619,2.132499428
4770,LP6005443-DNA_G08,16,38480,97910,97910,0.39301,64336,33574,1.916244713
4771,LP6005443-DNA_G08,17,34172,82854,82854,0.41244,58496,24358,2.401510797
4772,LP6005443-DNA_G08,18,23611,59947,59947,0.39386,41347,18600,2.222956989
4773,LP6005443-DNA_G08,19,24562,64236,64236,0.38237,45325,18911,2.396753212
4774,LP6005443-DNA_G08,2,113166,280481,280481,0.40347,190695,89786,2.123883456
4775,LP6005443-DNA_G08,20,28340,75287,75287,0.37643,52569,22718,2.313980104
4776,LP6005443-DNA_G08,21,17363,49270,49270,0.35241,33531,15739,2.130440308
4777,LP6005443-DNA_G08,22,13964,41233,41233,0.33866,29325,11908,2.462630165
4778,LP6005443-DNA_G08,3,91739,246586,246586,0.37204,166838,79748,2.092065005
4779,LP6005443-DNA_G08,4,90976,249698,249698,0.36434,168547,81151,2.076955306
4780,LP6005443-DNA_G08,5,79151,218138,218138,0.36285,147668,70470,2.095473251
4781,LP6005443-DNA_G08,6,78002,214216,214216,0.36413,146785,67431,2.176817784
4782,LP6005443-DNA_G08,7,73980,190798,190798,0.38774,129422,61376,2.1086744
4783,LP6005443-DNA_G08,8,69506,195808,195808,0.35497,129850,65958,1.968677037
4784,LP6005443-DNA_G08,9,51558,145921,145921,0.35333,97996,47925,2.044778299
4785,LP6005443-DNA_G08,MT,84,86,86,0.97674,82,4,20.5
4786,LP6005443-DNA_G08,X,81345,82251,82251,0.98898,55159,27092,2.035988484
4787,LP6005443-DNA_G08,Y,1325,1346,1346,0.9844,847,499,1.69739479
4788,LP6005443-DNA_G11,1,91826,193674,193674,0.47413,133471,60203,2.217015763
4789,LP6005443-DNA_G11,10,56651,126815,126815,0.44672,87337,39478,2.212295456
4790,LP6005443-DNA_G11,11,56970,125841,125841,0.45271,85294,40547,2.103583496
4791,LP6005443-DNA_G11,12,54617,115491,115491,0.47291,79386,36105,2.198753635
4792,LP6005443-DNA_G11,13,48993,98659,98659,0.49659,67316,31343,2.147720384
4793,LP6005443-DNA_G11,14,37214,80477,80477,0.46242,55051,25426,2.165145914
4794,LP6005443-DNA_G11,15,33852,71860,71860,0.47108,48904,22956,2.130336296
4795,LP6005443-DNA_G11,16,31549,73204,73204,0.43097,47959,25245,1.899742523
4796,LP6005443-DNA_G11,17,25681,58842,58842,0.43644,41487,17355,2.390492653
4797,LP6005443-DNA_G11,18,36568,73241,73241,0.49928,50129,23112,2.168959848
4798,LP6005443-DNA_G11,19,15864,47238,47238,0.33583,33307,13931,2.390854928
4799,LP6005443-DNA_G11,2,100249,207957,207957,0.48207,141347,66610,2.122008707
4800,LP6005443-DNA_G11,20,22302,51687,51687,0.43148,35971,15716,2.288813948
4801,LP6005443-DNA_G11,21,15320,34157,34157,0.44852,23342,10815,2.158298659
4802,LP6005443-DNA_G11,22,12276,31236,31236,0.39301,22045,9191,2.398542052
4803,LP6005443-DNA_G11,3,85050,178066,178066,0.47763,120242,57824,2.07944798
4804,LP6005443-DNA_G11,4,87026,190713,190713,0.45632,128804,61909,2.080537563
4805,LP6005443-DNA_G11,5,65991,155457,155457,0.4245,104893,50564,2.07446009
4806,LP6005443-DNA_G11,6,72515,158939,158939,0.45624,108887,50052,2.175477503
4807,LP6005443-DNA_G11,7,60155,137136,137136,0.43865,93007,44129,2.107616307
4808,LP6005443-DNA_G11,8,59650,132472,132472,0.45028,87403,45069,1.939315272
4809,LP6005443-DNA_G11,9,48398,106519,106519,0.45436,71129,35390,2.009861543
4810,LP6005443-DNA_G11,MT,31,32,32,0.96875,NA,NA,NA
4811,LP6005443-DNA_G11,X,52191,53031,53031,0.98416,35675,17356,2.055485135
4812,LP6005443-DNA_G11,Y,526,553,553,0.95118,350,203,1.724137931
4813,LP6005443-DNA_H01,1,82409,197914,197914,0.41639,136375,61539,2.216074359
4814,LP6005443-DNA_H01,10,55517,125937,125937,0.44083,86758,39179,2.214400572
4815,LP6005443-DNA_H01,11,53418,127658,127658,0.41845,86294,41364,2.086210231
4816,LP6005443-DNA_H01,12,50223,121721,121721,0.41261,83720,38001,2.203099918
4817,LP6005443-DNA_H01,13,47976,104107,104107,0.46083,70754,33353,2.121368393
4818,LP6005443-DNA_H01,14,33889,83625,83625,0.40525,57082,26543,2.150548167
4819,LP6005443-DNA_H01,15,31050,75205,75205,0.41287,51110,24095,2.121186968
4820,LP6005443-DNA_H01,16,29889,71145,71145,0.42011,46573,24572,1.895368712
4821,LP6005443-DNA_H01,17,22575,56747,56747,0.39782,40029,16718,2.394365355
4822,LP6005443-DNA_H01,18,33353,78974,78974,0.42233,54135,24839,2.179435565
4823,LP6005443-DNA_H01,19,13132,37822,37822,0.34721,26624,11198,2.377567423
4824,LP6005443-DNA_H01,2,93441,217629,217629,0.42936,147583,70046,2.106944008
4825,LP6005443-DNA_H01,20,22156,53344,53344,0.41534,37024,16320,2.268627451
4826,LP6005443-DNA_H01,21,14590,35731,35731,0.40833,24352,11379,2.140082608
4827,LP6005443-DNA_H01,22,10914,27377,27377,0.39866,19311,8066,2.394123481
4828,LP6005443-DNA_H01,3,78280,192952,192952,0.4057,130211,62741,2.07537336
4829,LP6005443-DNA_H01,4,86708,196504,196504,0.44125,132695,63809,2.079565579
4830,LP6005443-DNA_H01,5,64306,164048,164048,0.392,110585,53463,2.068439856
4831,LP6005443-DNA_H01,6,67154,172799,172799,0.38862,118279,54520,2.169460748
4832,LP6005443-DNA_H01,7,56071,142152,142152,0.39444,96572,45580,2.118736288
4833,LP6005443-DNA_H01,8,56751,141525,141525,0.401,94012,47513,1.978658472
4834,LP6005443-DNA_H01,9,43181,110053,110053,0.39237,73393,36660,2.001991271
4835,LP6005443-DNA_H01,MT,38,41,41,0.92683,39,2,19.5
4836,LP6005443-DNA_H01,X,51267,52015,52015,0.98562,34998,17017,2.056649233
4837,LP6005443-DNA_H01,Y,384,395,395,0.97215,241,154,1.564935065
4838,LP6005443-DNA_H02,1,81950,192239,192239,0.42629,132207,60032,2.202275453
4839,LP6005443-DNA_H02,10,49413,128617,128617,0.38419,88461,40156,2.202933559
4840,LP6005443-DNA_H02,11,54106,126391,126391,0.42808,85511,40880,2.09175636
4841,LP6005443-DNA_H02,12,51572,116388,116388,0.4431,79905,36483,2.190198174
4842,LP6005443-DNA_H02,13,48588,105131,105131,0.46217,71385,33746,2.115361821
4843,LP6005443-DNA_H02,14,32780,82350,82350,0.39806,56067,26283,2.133203972
4844,LP6005443-DNA_H02,15,34948,69316,69316,0.50418,47317,21999,2.150870494
4845,LP6005443-DNA_H02,16,28449,72017,72017,0.39503,47135,24882,1.894341291
4846,LP6005443-DNA_H02,17,21852,56450,56450,0.3871,39829,16621,2.396305878
4847,LP6005443-DNA_H02,18,33069,76189,76189,0.43404,52282,23907,2.186890869
4848,LP6005443-DNA_H02,19,13956,41290,41290,0.338,29087,12203,2.383594198
4849,LP6005443-DNA_H02,2,90391,217248,217248,0.41607,147291,69957,2.105450491
4850,LP6005443-DNA_H02,20,18428,54266,54266,0.33959,37700,16566,2.275745503
4851,LP6005443-DNA_H02,21,23209,28969,28969,0.80117,19708,9261,2.128063924
4852,LP6005443-DNA_H02,22,9597,26891,26891,0.35689,19034,7857,2.422553137
4853,LP6005443-DNA_H02,3,74770,187354,187354,0.39908,126252,61102,2.066249877
4854,LP6005443-DNA_H02,4,88484,199981,199981,0.44246,135067,64914,2.080706781
4855,LP6005443-DNA_H02,5,58335,162552,162552,0.35887,109713,52839,2.076364049
4856,LP6005443-DNA_H02,6,58562,164639,164639,0.3557,112620,52019,2.164978181
4857,LP6005443-DNA_H02,7,63808,135650,135650,0.47039,92080,43570,2.113380767
4858,LP6005443-DNA_H02,8,54958,142538,142538,0.38557,94359,48179,1.958508894
4859,LP6005443-DNA_H02,9,45147,106720,106720,0.42304,71032,35688,1.990360906
4860,LP6005443-DNA_H02,MT,38,39,39,0.97436,37,2,18.5
4861,LP6005443-DNA_H02,X,29241,76223,76223,0.38362,51439,24784,2.075492253
4862,LP6005443-DNA_H05,1,77413,191956,191956,0.40329,132409,59547,2.223604884
4863,LP6005443-DNA_H05,10,51888,127080,127080,0.40831,87337,39743,2.197544222
4864,LP6005443-DNA_H05,11,49994,127026,127026,0.39357,86052,40974,2.100161078
4865,LP6005443-DNA_H05,12,45523,116173,116173,0.39186,79945,36228,2.20671856
4866,LP6005443-DNA_H05,13,43829,102693,102693,0.4268,70037,32656,2.144690103
4867,LP6005443-DNA_H05,14,32507,81761,81761,0.39759,55944,25817,2.166944262
4868,LP6005443-DNA_H05,15,30465,70804,70804,0.43027,48273,22531,2.142514757
4869,LP6005443-DNA_H05,16,28126,69511,69511,0.40463,45501,24010,1.895085381
4870,LP6005443-DNA_H05,17,23608,56920,56920,0.41476,40175,16745,2.399223649
4871,LP6005443-DNA_H05,18,29956,73145,73145,0.40954,50141,23004,2.179664406
4872,LP6005443-DNA_H05,19,15197,40864,40864,0.37189,28919,11945,2.421012976
4873,LP6005443-DNA_H05,2,82212,211616,211616,0.3885,143611,68005,2.111771193
4874,LP6005443-DNA_H05,20,18688,50624,50624,0.36915,35215,15409,2.285352716
4875,LP6005443-DNA_H05,21,14113,34347,34347,0.41089,23391,10956,2.134994524
4876,LP6005443-DNA_H05,22,9288,28543,28543,0.3254,20287,8256,2.457243217
4877,LP6005443-DNA_H05,3,68822,181054,181054,0.38012,122444,58610,2.089131548
4878,LP6005443-DNA_H05,4,77527,190301,190301,0.40739,128719,61582,2.09020493
4879,LP6005443-DNA_H05,5,59493,159941,159941,0.37197,108297,51644,2.096990938
4880,LP6005443-DNA_H05,6,57623,167422,167422,0.34418,114648,52774,2.172433395
4881,LP6005443-DNA_H05,7,52986,139519,139519,0.37978,95075,44444,2.139208892
4882,LP6005443-DNA_H05,8,50651,138217,138217,0.36646,91362,46855,1.949887952
4883,LP6005443-DNA_H05,9,41140,104363,104363,0.3942,69748,34615,2.014964611
4884,LP6005443-DNA_H05,MT,34,36,36,0.94444,34,2,17
4885,LP6005443-DNA_H05,X,48372,49057,49057,0.98604,33009,16048,2.056891825
4886,LP6005443-DNA_H05,Y,691,699,699,0.98856,429,270,1.588888889
4887,LP6005443-DNA_H07,1,97322,194253,194253,0.50101,134034,60219,2.225775918
4888,LP6005443-DNA_H07,10,60320,120518,120518,0.50051,83020,37498,2.213984746
4889,LP6005443-DNA_H07,11,65363,115542,115542,0.56571,78333,37209,2.10521648
4890,LP6005443-DNA_H07,12,58754,116526,116526,0.50421,80171,36355,2.205226241
4891,LP6005443-DNA_H07,13,53145,93867,93867,0.56617,63924,29943,2.134856227
4892,LP6005443-DNA_H07,14,41655,79129,79129,0.52642,54080,25049,2.158968422
4893,LP6005443-DNA_H07,15,35071,72994,72994,0.48046,49745,23249,2.139661921
4894,LP6005443-DNA_H07,16,34122,72387,72387,0.47138,47535,24852,1.912723322
4895,LP6005443-DNA_H07,17,28473,61410,61410,0.46365,43278,18132,2.386829914
4896,LP6005443-DNA_H07,18,36542,74014,74014,0.49372,50714,23300,2.176566524
4897,LP6005443-DNA_H07,19,20844,45057,45057,0.46261,31751,13306,2.386216744
4898,LP6005443-DNA_H07,2,109638,200931,200931,0.54565,136518,64413,2.119416888
4899,LP6005443-DNA_H07,20,24861,52633,52633,0.47235,36787,15846,2.321532248
4900,LP6005443-DNA_H07,21,15898,37084,37084,0.4287,25363,11721,2.163893866
4901,LP6005443-DNA_H07,22,15312,28874,28874,0.5303,20561,8313,2.473354986
4902,LP6005443-DNA_H07,3,93386,184564,184564,0.50598,124839,59725,2.090230222
4903,LP6005443-DNA_H07,4,93024,179074,179074,0.51947,121151,57923,2.091587107
4904,LP6005443-DNA_H07,5,75798,147425,147425,0.51415,99606,47819,2.082979569
4905,LP6005443-DNA_H07,6,81955,158894,158894,0.51578,108651,50243,2.1625102
4906,LP6005443-DNA_H07,7,67994,132703,132703,0.51238,90299,42404,2.129492501
4907,LP6005443-DNA_H07,8,72307,129768,129768,0.5572,85952,43816,1.961657842
4908,LP6005443-DNA_H07,9,55687,100621,100621,0.55343,67265,33356,2.016578726
4909,LP6005443-DNA_H07,MT,41,43,43,0.95349,NA,NA,NA
4910,LP6005443-DNA_H07,X,52014,52630,52630,0.9883,35349,17281,2.045541346
4911,LP6005443-DNA_H07,Y,664,679,679,0.97791,427,252,1.694444444
4912,LP6005443-DNA_H08,1,80639,233511,233511,0.34533,161134,72377,2.22631499
4913,LP6005443-DNA_H08,10,51317,146639,146639,0.34995,100959,45680,2.210135727
4914,LP6005443-DNA_H08,11,50527,147461,147461,0.34265,100220,47241,2.121462289
4915,LP6005443-DNA_H08,12,47391,137210,137210,0.34539,94439,42771,2.208014776
4916,LP6005443-DNA_H08,13,40180,113971,113971,0.35255,77632,36339,2.136327362
4917,LP6005443-DNA_H08,14,36257,97261,97261,0.37278,66554,30707,2.167388543
4918,LP6005443-DNA_H08,15,29188,86980,86980,0.33557,59184,27796,2.129227227
4919,LP6005443-DNA_H08,16,31785,88852,88852,0.35773,58629,30223,1.939880224
4920,LP6005443-DNA_H08,17,26143,76872,76872,0.34008,54257,22615,2.39915985
4921,LP6005443-DNA_H08,18,30130,85881,85881,0.35083,58857,27024,2.177952931
4922,LP6005443-DNA_H08,19,20062,58296,58296,0.34414,40967,17329,2.364071787
4923,LP6005443-DNA_H08,2,87591,252228,252228,0.34727,171088,81140,2.108553118
4924,LP6005443-DNA_H08,20,21659,67127,67127,0.32266,46677,20450,2.282493888
4925,LP6005443-DNA_H08,21,15313,44291,44291,0.34574,30310,13981,2.167942207
4926,LP6005443-DNA_H08,22,13447,37701,37701,0.35667,26776,10925,2.450892449
4927,LP6005443-DNA_H08,3,78428,217405,217405,0.36075,147023,70382,2.088928988
4928,LP6005443-DNA_H08,4,77811,221520,221520,0.35126,149773,71747,2.087515854
4929,LP6005443-DNA_H08,5,65497,190400,190400,0.344,128735,61665,2.087651018
4930,LP6005443-DNA_H08,6,68678,194345,194345,0.35338,133302,61043,2.183739331
4931,LP6005443-DNA_H08,7,59632,169651,169651,0.3515,115114,54537,2.1107505
4932,LP6005443-DNA_H08,8,59507,168500,168500,0.35316,111754,56746,1.969372291
4933,LP6005443-DNA_H08,9,44048,124639,124639,0.3534,83514,41125,2.030735562
4934,LP6005443-DNA_H08,MT,60,61,61,0.98361,60,1,60
4935,LP6005443-DNA_H08,X,69495,70371,70371,0.98755,47264,23107,2.045440776
4936,LP6005443-DNA_H08,Y,934,960,960,0.97292,593,367,1.615803815
4937,LP6005443-DNA_H11,1,86036,200108,200108,0.42995,137960,62148,2.219862264
4938,LP6005443-DNA_H11,10,54189,129712,129712,0.41776,88977,40735,2.184288695
4939,LP6005443-DNA_H11,11,56257,128069,128069,0.43927,86955,41114,2.114973002
4940,LP6005443-DNA_H11,12,52116,120480,120480,0.43257,82803,37677,2.197706824
4941,LP6005443-DNA_H11,13,43660,104420,104420,0.41812,71283,33137,2.151160334
4942,LP6005443-DNA_H11,14,35756,81625,81625,0.43805,55697,25928,2.148141006
4943,LP6005443-DNA_H11,15,29845,74088,74088,0.40283,50473,23615,2.13732797
4944,LP6005443-DNA_H11,16,30222,76175,76175,0.39674,49898,26277,1.898923013
4945,LP6005443-DNA_H11,17,26174,61163,61163,0.42794,43181,17982,2.40134579
4946,LP6005443-DNA_H11,18,35045,75111,75111,0.46658,51628,23483,2.198526594
4947,LP6005443-DNA_H11,19,17963,45835,45835,0.39191,32251,13584,2.374190224
4948,LP6005443-DNA_H11,2,90991,213451,213451,0.42629,145132,68319,2.124328518
4949,LP6005443-DNA_H11,20,18679,55050,55050,0.33931,38433,16617,2.31287236
4950,LP6005443-DNA_H11,21,14660,34833,34833,0.42087,23775,11058,2.15002713
4951,LP6005443-DNA_H11,22,10676,29667,29667,0.35986,20991,8676,2.419432918
4952,LP6005443-DNA_H11,3,75621,188931,188931,0.40026,127598,61333,2.080413481
4953,LP6005443-DNA_H11,4,83095,199691,199691,0.41612,134960,64731,2.08493612
4954,LP6005443-DNA_H11,5,62656,157262,157262,0.39842,106112,51150,2.074525904
4955,LP6005443-DNA_H11,6,68770,170555,170555,0.40321,116749,53806,2.169813775
4956,LP6005443-DNA_H11,7,57419,144217,144217,0.39814,98101,46116,2.127266025
4957,LP6005443-DNA_H11,8,57067,138896,138896,0.41086,92228,46668,1.976257821
4958,LP6005443-DNA_H11,9,46415,106851,106851,0.43439,71464,35387,2.019498686
4959,LP6005443-DNA_H11,MT,37,38,38,0.97368,37,1,37
4960,LP6005443-DNA_H11,X,30428,81425,81425,0.37369,54834,26591,2.062126283
4961,LP6005519-DNA_A04,1,77292,199987,199987,0.38649,137915,62072,2.221855265
4962,LP6005519-DNA_A04,10,49297,130607,130607,0.37745,89726,40881,2.194809325
4963,LP6005519-DNA_A04,11,51507,128659,128659,0.40034,87271,41388,2.108606359
4964,LP6005519-DNA_A04,12,44901,119157,119157,0.37682,81774,37383,2.18746489
4965,LP6005519-DNA_A04,13,45319,102817,102817,0.44077,70159,32658,2.148294445
4966,LP6005519-DNA_A04,14,32926,85803,85803,0.38374,58702,27101,2.166045533
4967,LP6005519-DNA_A04,15,29536,70069,70069,0.42153,47636,22433,2.123478804
4968,LP6005519-DNA_A04,16,27119,74998,74998,0.3616,49064,25934,1.891879386
4969,LP6005519-DNA_A04,17,22268,57893,57893,0.38464,40800,17093,2.386942023
4970,LP6005519-DNA_A04,18,31332,75968,75968,0.41244,52024,23944,2.172736385
4971,LP6005519-DNA_A04,19,14733,43158,43158,0.34137,30281,12877,2.35155704
4972,LP6005519-DNA_A04,2,89910,212996,212996,0.42212,144742,68254,2.120637618
4973,LP6005519-DNA_A04,20,18205,51164,51164,0.35582,35547,15617,2.276173401
4974,LP6005519-DNA_A04,21,14380,35768,35768,0.40204,24278,11490,2.112967798
4975,LP6005519-DNA_A04,22,10284,27075,27075,0.37983,19235,7840,2.453443878
4976,LP6005519-DNA_A04,3,71394,193027,193027,0.36987,130424,62603,2.083350638
4977,LP6005519-DNA_A04,4,81163,201381,201381,0.40303,135849,65532,2.073017762
4978,LP6005519-DNA_A04,5,61863,163669,163669,0.37798,110514,53155,2.079089455
4979,LP6005519-DNA_A04,6,62927,171448,171448,0.36703,117232,54216,2.162313708
4980,LP6005519-DNA_A04,7,51154,142085,142085,0.36002,96565,45520,2.12137522
4981,LP6005519-DNA_A04,8,52288,140430,140430,0.37234,92847,47583,1.951264107
4982,LP6005519-DNA_A04,9,40646,108917,108917,0.37318,72723,36194,2.009255678
4983,LP6005519-DNA_A04,MT,32,33,33,0.9697,NA,NA,NA
4984,LP6005519-DNA_A04,X,54265,54932,54932,0.98786,36983,17949,2.06044905
4985,LP6005519-DNA_A04,Y,698,709,709,0.98449,419,290,1.444827586
4986,LP6005519-DNA_A05,1,80920,197665,197665,0.40938,135998,61667,2.205361052
4987,LP6005519-DNA_A05,10,51023,131966,131966,0.38664,90679,41287,2.196308765
4988,LP6005519-DNA_A05,11,52453,132803,132803,0.39497,90138,42665,2.112691902
4989,LP6005519-DNA_A05,12,46707,125763,125763,0.37139,86276,39487,2.18492162
4990,LP6005519-DNA_A05,13,44948,110168,110168,0.408,74929,35239,2.126308919
4991,LP6005519-DNA_A05,14,34044,86574,86574,0.39324,58991,27583,2.138672371
4992,LP6005519-DNA_A05,15,30620,74421,74421,0.41144,50712,23709,2.138934582
4993,LP6005519-DNA_A05,16,29297,73823,73823,0.39685,48258,25565,1.887658909
4994,LP6005519-DNA_A05,17,22804,58524,58524,0.38965,41131,17393,2.364801932
4995,LP6005519-DNA_A05,18,31657,80288,80288,0.39429,55105,25183,2.188182504
4996,LP6005519-DNA_A05,19,14984,41557,41557,0.36057,29319,12238,2.395734597
4997,LP6005519-DNA_A05,2,89964,223977,223977,0.40167,152393,71584,2.12886958
4998,LP6005519-DNA_A05,20,20045,54614,54614,0.36703,38047,16567,2.296553389
4999,LP6005519-DNA_A05,21,14668,37053,37053,0.39587,25349,11704,2.165840738
5000,LP6005519-DNA_A05,22,10043,28418,28418,0.3534,20082,8336,2.409069098
5001,LP6005519-DNA_A05,3,74702,195069,195069,0.38295,131731,63338,2.079809909
5002,LP6005519-DNA_A05,4,82231,197800,197800,0.41573,133384,64416,2.070665673
5003,LP6005519-DNA_A05,5,60986,169984,169984,0.35877,114796,55188,2.080089875
5004,LP6005519-DNA_A05,6,65874,170041,170041,0.3874,116569,53472,2.180000748
5005,LP6005519-DNA_A05,7,56660,144541,144541,0.392,98235,46306,2.121431348
5006,LP6005519-DNA_A05,8,54935,147339,147339,0.37285,97449,49890,1.95327721
5007,LP6005519-DNA_A05,9,42270,109657,109657,0.38547,73139,36518,2.002820527
5008,LP6005519-DNA_A05,MT,36,37,37,0.97297,36,1,36
5009,LP6005519-DNA_A05,X,54109,54875,54875,0.98604,36760,18115,2.029257521
5010,LP6005519-DNA_A05,Y,392,398,398,0.98492,240,158,1.518987342
5011,LP6005519-DNA_A06,1,82923,196943,196943,0.42105,135736,61207,2.217654843
5012,LP6005519-DNA_A06,10,53312,129229,129229,0.41254,89007,40222,2.212893441
5013,LP6005519-DNA_A06,11,53498,128271,128271,0.41707,86930,41341,2.102755134
5014,LP6005519-DNA_A06,12,48616,119038,119038,0.40841,81780,37258,2.19496484
5015,LP6005519-DNA_A06,13,45341,104936,104936,0.43208,71273,33663,2.117250394
5016,LP6005519-DNA_A06,14,33420,83467,83467,0.4004,56969,26498,2.149935844
5017,LP6005519-DNA_A06,15,29183,72586,72586,0.40205,49431,23155,2.134787303
5018,LP6005519-DNA_A06,16,28319,73899,73899,0.38321,48557,25342,1.916068187
5019,LP6005519-DNA_A06,17,23539,56363,56363,0.41763,39716,16647,2.385775215
5020,LP6005519-DNA_A06,18,31263,77955,77955,0.40104,53416,24539,2.17677982
5021,LP6005519-DNA_A06,19,15389,41544,41544,0.37043,29283,12261,2.38830438
5022,LP6005519-DNA_A06,2,89593,217829,217829,0.4113,147794,70035,2.110287713
5023,LP6005519-DNA_A06,20,21731,53374,53374,0.40715,37207,16167,2.301416466
5024,LP6005519-DNA_A06,21,13748,36547,36547,0.37617,24867,11680,2.129023973
5025,LP6005519-DNA_A06,22,10136,28070,28070,0.3611,19868,8202,2.422336016
5026,LP6005519-DNA_A06,3,78146,187847,187847,0.41601,126964,60883,2.08537687
5027,LP6005519-DNA_A06,4,84013,201852,201852,0.41621,136211,65641,2.075090264
5028,LP6005519-DNA_A06,5,62118,157686,157686,0.39393,106467,51219,2.078662215
5029,LP6005519-DNA_A06,6,65278,170306,170306,0.3833,116604,53702,2.17131578
5030,LP6005519-DNA_A06,7,55886,141296,141296,0.39552,96237,45059,2.135799729
5031,LP6005519-DNA_A06,8,55291,141943,141943,0.38953,93676,48267,1.940787702
5032,LP6005519-DNA_A06,9,41382,108182,108182,0.38252,72252,35930,2.010910103
5033,LP6005519-DNA_A06,MT,41,42,42,0.97619,41,1,41
5034,LP6005519-DNA_A06,X,53651,54241,54241,0.98912,36639,17602,2.081524827
5035,LP6005519-DNA_A06,Y,686,697,697,0.98422,459,238,1.928571429
5036,LP6005519-DNA_B04,1,78790,199160,199160,0.39561,137119,62041,2.210135233
5037,LP6005519-DNA_B04,10,48787,130100,130100,0.375,89451,40649,2.20057074
5038,LP6005519-DNA_B04,11,53714,127722,127722,0.42055,86609,41113,2.106608615
5039,LP6005519-DNA_B04,12,49530,118779,118779,0.41699,81593,37186,2.194185984
5040,LP6005519-DNA_B04,13,44117,106920,106920,0.41262,72786,34134,2.132360696
5041,LP6005519-DNA_B04,14,33773,85122,85122,0.39676,58123,26999,2.152783436
5042,LP6005519-DNA_B04,15,28423,73692,73692,0.3857,50261,23431,2.145064231
5043,LP6005519-DNA_B04,16,28075,72657,72657,0.3864,47595,25062,1.899090256
5044,LP6005519-DNA_B04,17,21854,59827,59827,0.36529,42254,17573,2.404484152
5045,LP6005519-DNA_B04,18,31414,76473,76473,0.41079,52420,24053,2.179353927
5046,LP6005519-DNA_B04,19,14475,43737,43737,0.33096,30826,12911,2.387576485
5047,LP6005519-DNA_B04,2,86778,219520,219520,0.39531,148837,70683,2.105697268
5048,LP6005519-DNA_B04,20,20179,53761,53761,0.37535,37488,16273,2.303693234
5049,LP6005519-DNA_B04,21,14381,36188,36188,0.3974,24702,11486,2.150618144
5050,LP6005519-DNA_B04,22,10173,27101,27101,0.37537,19220,7881,2.438776805
5051,LP6005519-DNA_B04,3,75492,187062,187062,0.40357,126459,60603,2.086678877
5052,LP6005519-DNA_B04,4,84629,196086,196086,0.43159,132315,63771,2.074845933
5053,LP6005519-DNA_B04,5,60687,161592,161592,0.37556,109157,52435,2.081758368
5054,LP6005519-DNA_B04,6,60520,167215,167215,0.36193,114371,52844,2.164313829
5055,LP6005519-DNA_B04,7,53094,142919,142919,0.3715,97040,45879,2.115128926
5056,LP6005519-DNA_B04,8,52569,144414,144414,0.36402,95636,48778,1.960637993
5057,LP6005519-DNA_B04,9,39713,107742,107742,0.36859,71754,35988,1.993831277
5058,LP6005519-DNA_B04,MT,32,33,33,0.9697,NA,NA,NA
5059,LP6005519-DNA_B04,X,53289,53944,53944,0.98786,36334,17610,2.063259512
5060,LP6005519-DNA_B04,Y,680,687,687,0.98981,430,257,1.673151751
5061,LP6005519-DNA_B05,1,79501,198995,198995,0.39951,136816,62179,2.200357034
5062,LP6005519-DNA_B05,10,62438,120354,120354,0.51879,82520,37834,2.181106941
5063,LP6005519-DNA_B05,11,52510,127206,127206,0.41279,85886,41320,2.078557599
5064,LP6005519-DNA_B05,12,47194,121332,121332,0.38897,83192,38140,2.181227058
5065,LP6005519-DNA_B05,13,45333,107594,107594,0.42133,73084,34510,2.117762967
5066,LP6005519-DNA_B05,14,44079,70768,70768,0.62287,48466,22302,2.173168326
5067,LP6005519-DNA_B05,15,28607,74151,74151,0.38579,50495,23656,2.134553602
5068,LP6005519-DNA_B05,16,29003,73440,73440,0.39492,48193,25247,1.908860459
5069,LP6005519-DNA_B05,17,21421,56750,56750,0.37746,39880,16870,2.363959692
5070,LP6005519-DNA_B05,18,34148,78280,78280,0.43623,53543,24737,2.164490439
5071,LP6005519-DNA_B05,19,14493,39921,39921,0.36304,28081,11840,2.371706081
5072,LP6005519-DNA_B05,2,86563,220023,220023,0.39343,149383,70640,2.114708381
5073,LP6005519-DNA_B05,20,22970,50686,50686,0.45318,35305,15381,2.295364411
5074,LP6005519-DNA_B05,21,15533,34811,34811,0.44621,23814,10997,2.165499682
5075,LP6005519-DNA_B05,22,9927,25626,25626,0.38738,18051,7575,2.382970297
5076,LP6005519-DNA_B05,3,84307,180246,180246,0.46773,121876,58370,2.087990406
5077,LP6005519-DNA_B05,4,80187,201437,201437,0.39807,136085,65352,2.08233872
5078,LP6005519-DNA_B05,5,60809,164351,164351,0.36999,110867,53484,2.072900307
5079,LP6005519-DNA_B05,6,64375,170570,170570,0.37741,116704,53866,2.166561467
5080,LP6005519-DNA_B05,7,57912,140095,140095,0.41338,94896,45199,2.099515476
5081,LP6005519-DNA_B05,8,51751,145008,145008,0.35688,95937,49071,1.95506511
5082,LP6005519-DNA_B05,9,45440,105091,105091,0.43239,70413,34678,2.03048042
5083,LP6005519-DNA_B05,MT,37,37,37,1,35,2,17.5
5084,LP6005519-DNA_B05,X,52205,52909,52909,0.98669,35480,17429,2.035687647
5085,LP6005519-DNA_B05,Y,713,733,733,0.97271,452,281,1.608540925
5086,LP6005519-DNA_B06,1,81224,191729,191729,0.42364,131747,59982,2.196442266
5087,LP6005519-DNA_B06,10,55935,124831,124831,0.44809,85805,39026,2.19866243
5088,LP6005519-DNA_B06,11,53979,122823,122823,0.43949,83191,39632,2.099086597
5089,LP6005519-DNA_B06,12,49738,117996,117996,0.42152,80861,37135,2.177487545
5090,LP6005519-DNA_B06,13,44501,102372,102372,0.4347,69722,32650,2.135436447
5091,LP6005519-DNA_B06,14,33097,82340,82340,0.40196,56176,26164,2.147072313
5092,LP6005519-DNA_B06,15,30492,72715,72715,0.41934,49527,23188,2.135889253
5093,LP6005519-DNA_B06,16,28469,71234,71234,0.39965,46573,24661,1.888528446
5094,LP6005519-DNA_B06,17,22234,55332,55332,0.40183,38961,16371,2.379879054
5095,LP6005519-DNA_B06,18,32831,76511,76511,0.4291,52243,24268,2.152752596
5096,LP6005519-DNA_B06,19,14202,39073,39073,0.36347,27598,11475,2.405054466
5097,LP6005519-DNA_B06,2,91489,215083,215083,0.42537,146020,69063,2.114301435
5098,LP6005519-DNA_B06,20,21501,51513,51513,0.41739,35759,15754,2.269836232
5099,LP6005519-DNA_B06,21,14540,36105,36105,0.40271,24660,11445,2.154652687
5100,LP6005519-DNA_B06,22,10885,26385,26385,0.41255,18703,7682,2.434652434
5101,LP6005519-DNA_B06,3,77222,187457,187457,0.41195,126455,61002,2.072964821
5102,LP6005519-DNA_B06,4,84348,200087,200087,0.42156,135292,64795,2.088000617
5103,LP6005519-DNA_B06,5,60129,158081,158081,0.38037,106602,51479,2.070786146
5104,LP6005519-DNA_B06,6,65537,169574,169574,0.38648,116061,53513,2.168837479
5105,LP6005519-DNA_B06,7,57986,142416,142416,0.40716,96488,45928,2.10085351
5106,LP6005519-DNA_B06,8,54215,137408,137408,0.39455,90662,46746,1.939460061
5107,LP6005519-DNA_B06,9,44386,107609,107609,0.41247,71754,35855,2.001227165
5108,LP6005519-DNA_B06,MT,33,37,37,0.89189,36,1,36
5109,LP6005519-DNA_B06,X,52714,53309,53309,0.98884,35910,17399,2.063911719
5110,LP6005519-DNA_B06,Y,631,638,638,0.98903,410,228,1.798245614
5111,LP6005519-DNA_C03,1,93046,180885,180885,0.51439,124539,56346,2.210254499
5112,LP6005519-DNA_C03,10,50341,127600,127600,0.39452,87819,39781,2.207561399
5113,LP6005519-DNA_C03,11,54162,128010,128010,0.42311,86687,41323,2.097790577
5114,LP6005519-DNA_C03,12,54397,116344,116344,0.46755,79757,36587,2.179927297
5115,LP6005519-DNA_C03,13,44432,104858,104858,0.42373,71381,33477,2.132240045
5116,LP6005519-DNA_C03,14,36035,82258,82258,0.43807,56006,26252,2.13339936
5117,LP6005519-DNA_C03,15,31186,71099,71099,0.43863,48378,22721,2.129219665
5118,LP6005519-DNA_C03,16,28227,73373,73373,0.38471,48033,25340,1.895540647
5119,LP6005519-DNA_C03,17,22337,57930,57930,0.38559,40892,17038,2.400046954
5120,LP6005519-DNA_C03,18,29821,76813,76813,0.38823,52689,24124,2.184090532
5121,LP6005519-DNA_C03,19,14863,42694,42694,0.34813,30069,12625,2.38170297
5122,LP6005519-DNA_C03,2,94267,205395,205395,0.45895,139270,66125,2.106162571
5123,LP6005519-DNA_C03,20,26876,45290,45290,0.59342,31559,13731,2.298375938
5124,LP6005519-DNA_C03,21,14421,36589,36589,0.39413,25059,11530,2.173373807
5125,LP6005519-DNA_C03,22,10313,27643,27643,0.37308,19481,8162,2.386792453
5126,LP6005519-DNA_C03,3,69414,187917,187917,0.36939,127151,60766,2.092469473
5127,LP6005519-DNA_C03,4,80640,197567,197567,0.40817,133636,63931,2.090316122
5128,LP6005519-DNA_C03,5,72950,152654,152654,0.47788,102952,49702,2.071385457
5129,LP6005519-DNA_C03,6,64295,167558,167558,0.38372,114340,53218,2.148521177
5130,LP6005519-DNA_C03,7,56038,141544,141544,0.39591,96383,45161,2.13420872
5131,LP6005519-DNA_C03,8,51130,142380,142380,0.35911,94186,48194,1.954309665
5132,LP6005519-DNA_C03,9,51105,99620,99620,0.513,66410,33210,1.999698886
5133,LP6005519-DNA_C03,MT,9,10,10,0.9,NA,NA,NA
5134,LP6005519-DNA_C03,X,50328,50869,50869,0.98936,34145,16724,2.041676632
5135,LP6005519-DNA_C03,Y,675,683,683,0.98829,425,258,1.647286822
5136,LP6005519-DNA_C04,1,78192,196780,196780,0.39736,135486,61294,2.210428427
5137,LP6005519-DNA_C04,10,50025,129809,129809,0.38537,89168,40641,2.194040501
5138,LP6005519-DNA_C04,11,53069,124617,124617,0.42586,84381,40236,2.097151804
5139,LP6005519-DNA_C04,12,49416,118621,118621,0.41659,81337,37284,2.181552409
5140,LP6005519-DNA_C04,13,44400,103629,103629,0.42845,70560,33069,2.133720403
5141,LP6005519-DNA_C04,14,31836,84632,84632,0.37617,57650,26982,2.136609592
5142,LP6005519-DNA_C04,15,31659,70138,70138,0.45138,47700,22438,2.12585792
5143,LP6005519-DNA_C04,16,30466,73876,73876,0.41239,48468,25408,1.907588161
5144,LP6005519-DNA_C04,17,22027,58154,58154,0.37877,41095,17059,2.408992321
5145,LP6005519-DNA_C04,18,31413,77781,77781,0.40386,53326,24455,2.180576569
5146,LP6005519-DNA_C04,19,14112,43679,43679,0.32308,30755,12924,2.379681213
5147,LP6005519-DNA_C04,2,87304,217795,217795,0.40085,147810,69985,2.112024005
5148,LP6005519-DNA_C04,20,24530,47655,47655,0.51474,33220,14435,2.301350883
5149,LP6005519-DNA_C04,21,14304,38239,38239,0.37407,25973,12266,2.117479211
5150,LP6005519-DNA_C04,22,9463,27279,27279,0.3469,19348,7931,2.439541041
5151,LP6005519-DNA_C04,3,73068,186487,186487,0.39181,126021,60466,2.084163001
5152,LP6005519-DNA_C04,4,78999,195596,195596,0.40389,132280,63316,2.089203361
5153,LP6005519-DNA_C04,5,63963,164116,164116,0.38974,110778,53338,2.076905771
5154,LP6005519-DNA_C04,6,62048,170855,170855,0.36316,116878,53977,2.165329677
5155,LP6005519-DNA_C04,7,54176,147580,147580,0.3671,100551,47029,2.138063748
5156,LP6005519-DNA_C04,8,59027,139304,139304,0.42373,91832,47472,1.934445568
5157,LP6005519-DNA_C04,9,43032,104299,104299,0.41258,69483,34816,1.995720358
5158,LP6005519-DNA_C04,MT,31,34,34,0.91176,32,2,16
5159,LP6005519-DNA_C04,X,53176,53713,53713,0.99,36157,17556,2.05952381
5160,LP6005519-DNA_C04,Y,723,738,738,0.97967,469,269,1.743494424
5161,LP6005519-DNA_C05,1,76204,193912,193912,0.39298,133551,60361,2.212537897
5162,LP6005519-DNA_C05,10,51705,130825,130825,0.39522,90007,40818,2.205081092
5163,LP6005519-DNA_C05,11,53780,124517,124517,0.43191,84380,40137,2.102299624
5164,LP6005519-DNA_C05,12,47797,120528,120528,0.39656,82749,37779,2.190343842
5165,LP6005519-DNA_C05,13,45834,104559,104559,0.43836,71355,33204,2.148988074
5166,LP6005519-DNA_C05,14,33521,84068,84068,0.39874,57340,26728,2.145315774
5167,LP6005519-DNA_C05,15,27933,75001,75001,0.37244,50930,24071,2.115824021
5168,LP6005519-DNA_C05,16,28876,74843,74843,0.38582,48973,25870,1.893042134
5169,LP6005519-DNA_C05,17,22406,58135,58135,0.38541,40987,17148,2.390191276
5170,LP6005519-DNA_C05,18,31657,76716,76716,0.41265,52527,24189,2.171524247
5171,LP6005519-DNA_C05,19,14786,41481,41481,0.35645,29110,12371,2.353083825
5172,LP6005519-DNA_C05,2,85977,218681,218681,0.39316,148345,70336,2.109090651
5173,LP6005519-DNA_C05,20,19215,53840,53840,0.35689,37501,16339,2.295183304
5174,LP6005519-DNA_C05,21,14911,36058,36058,0.41353,24538,11520,2.130034722
5175,LP6005519-DNA_C05,22,9316,28396,28396,0.32807,20097,8299,2.421617062
5176,LP6005519-DNA_C05,3,75003,185230,185230,0.40492,125212,60018,2.086240794
5177,LP6005519-DNA_C05,4,83177,198051,198051,0.41998,133852,64199,2.084954594
5178,LP6005519-DNA_C05,5,61094,163603,163603,0.37343,110487,53116,2.080107689
5179,LP6005519-DNA_C05,6,64457,171446,171446,0.37596,117318,54128,2.167417972
5180,LP6005519-DNA_C05,7,53571,144150,144150,0.37163,97791,46359,2.10942859
5181,LP6005519-DNA_C05,8,50700,141701,141701,0.3578,93752,47949,1.955244114
5182,LP6005519-DNA_C05,9,41709,109567,109567,0.38067,73077,36490,2.002658263
5183,LP6005519-DNA_C05,MT,46,48,48,0.95833,46,2,23
5184,LP6005519-DNA_C05,X,51683,52306,52306,0.98809,35291,17015,2.074111078
5185,LP6005519-DNA_C05,Y,424,437,437,0.97025,282,155,1.819354839
5186,LP6005519-DNA_C06,1,90891,192308,192308,0.47263,132631,59677,2.222481023
5187,LP6005519-DNA_C06,10,56646,127658,127658,0.44373,88049,39609,2.222954379
5188,LP6005519-DNA_C06,11,58178,121835,121835,0.47751,82539,39296,2.100442793
5189,LP6005519-DNA_C06,12,54627,122014,122014,0.44771,83806,38208,2.193414992
5190,LP6005519-DNA_C06,13,49128,102371,102371,0.4799,69621,32750,2.125832061
5191,LP6005519-DNA_C06,14,38742,80511,80511,0.4812,54841,25670,2.136384885
5192,LP6005519-DNA_C06,15,32321,70421,70421,0.45897,48028,22393,2.144777386
5193,LP6005519-DNA_C06,16,33377,72021,72021,0.46343,47151,24870,1.895898673
5194,LP6005519-DNA_C06,17,25493,58816,58816,0.43344,41458,17358,2.388408803
5195,LP6005519-DNA_C06,18,34210,74972,74972,0.4563,51266,23706,2.162574876
5196,LP6005519-DNA_C06,19,16505,39983,39983,0.4128,28140,11843,2.37608714
5197,LP6005519-DNA_C06,2,95406,212263,212263,0.44947,144082,68181,2.113228025
5198,LP6005519-DNA_C06,20,24084,52209,52209,0.4613,36387,15822,2.299772469
5199,LP6005519-DNA_C06,21,15763,33531,33531,0.4701,22984,10547,2.179197876
5200,LP6005519-DNA_C06,22,11663,28995,28995,0.40224,20544,8451,2.430954917
5201,LP6005519-DNA_C06,3,86375,175699,175699,0.49161,118761,56938,2.085795075
5202,LP6005519-DNA_C06,4,92209,189733,189733,0.48599,128307,61426,2.088806043
5203,LP6005519-DNA_C06,5,67493,155192,155192,0.4349,104494,50698,2.061106947
5204,LP6005519-DNA_C06,6,70394,166037,166037,0.42397,113905,52132,2.184934397
5205,LP6005519-DNA_C06,7,61097,139697,139697,0.43735,94967,44730,2.123116477
5206,LP6005519-DNA_C06,8,57666,136374,136374,0.42285,90231,46143,1.955464534
5207,LP6005519-DNA_C06,9,48003,104192,104192,0.46072,69594,34598,2.011503555
5208,LP6005519-DNA_C06,MT,33,35,35,0.94286,33,2,16.5
5209,LP6005519-DNA_C06,X,34683,71951,71951,0.48204,48567,23384,2.076932946
5210,LP6005519-DNA_D01,1,89796,184222,184222,0.48743,126753,57469,2.2055891
5211,LP6005519-DNA_D01,10,57137,120097,120097,0.47576,82327,37770,2.179692878
5212,LP6005519-DNA_D01,11,60387,118948,118948,0.50768,80429,38519,2.088034476
5213,LP6005519-DNA_D01,12,56783,112625,112625,0.50418,77452,35173,2.202029966
5214,LP6005519-DNA_D01,13,50183,98930,98930,0.50726,67273,31657,2.125059229
5215,LP6005519-DNA_D01,14,37352,79518,79518,0.46973,54207,25311,2.141638023
5216,LP6005519-DNA_D01,15,34219,68954,68954,0.49626,46882,22072,2.124048568
5217,LP6005519-DNA_D01,16,32688,66531,66531,0.49132,43428,23103,1.879755876
5218,LP6005519-DNA_D01,17,23613,51552,51552,0.45804,36169,15383,2.351231879
5219,LP6005519-DNA_D01,18,35997,73499,73499,0.48976,50265,23234,2.163424292
5220,LP6005519-DNA_D01,19,16509,36405,36405,0.45348,25480,10925,2.332265446
5221,LP6005519-DNA_D01,2,100929,204611,204611,0.49327,138712,65899,2.104918132
5222,LP6005519-DNA_D01,20,20003,49870,49870,0.4011,34781,15089,2.305056664
5223,LP6005519-DNA_D01,21,14658,33949,33949,0.43177,23174,10775,2.150719258
5224,LP6005519-DNA_D01,22,11378,25023,25023,0.4547,17712,7311,2.4226508
5225,LP6005519-DNA_D01,3,84086,182023,182023,0.46195,122716,59307,2.069165529
5226,LP6005519-DNA_D01,4,93731,187597,187597,0.49964,126477,61120,2.069322644
5227,LP6005519-DNA_D01,5,67216,150963,150963,0.44525,101716,49247,2.065425305
5228,LP6005519-DNA_D01,6,75865,158776,158776,0.47781,108395,50381,2.151505528
5229,LP6005519-DNA_D01,7,63927,133134,133134,0.48017,90323,42811,2.109808227
5230,LP6005519-DNA_D01,8,62349,129552,129552,0.48127,85586,43966,1.946640586
5231,LP6005519-DNA_D01,9,48209,104299,104299,0.46222,69477,34822,1.995204181
5232,LP6005519-DNA_D01,MT,32,37,37,0.86486,33,4,8.25
5233,LP6005519-DNA_D01,X,49060,49594,49594,0.98923,33246,16348,2.033643259
5234,LP6005519-DNA_D01,Y,514,524,524,0.98092,334,190,1.757894737
5235,LP6005519-DNA_D03,1,74808,195531,195531,0.38259,134847,60684,2.222117856
5236,LP6005519-DNA_D03,10,49411,127971,127971,0.38611,87976,39995,2.199674959
5237,LP6005519-DNA_D03,11,52591,125359,125359,0.41952,85190,40169,2.120789664
5238,LP6005519-DNA_D03,12,46495,117684,117684,0.39508,80815,36869,2.191949877
5239,LP6005519-DNA_D03,13,44156,104503,104503,0.42253,71141,33362,2.132396139
5240,LP6005519-DNA_D03,14,29769,80779,80779,0.36852,55270,25509,2.166686268
5241,LP6005519-DNA_D03,15,29060,71811,71811,0.40467,48852,22959,2.127793022
5242,LP6005519-DNA_D03,16,28539,72770,72770,0.39218,47709,25061,1.903714936
5243,LP6005519-DNA_D03,17,22655,58577,58577,0.38676,41277,17300,2.385953757
5244,LP6005519-DNA_D03,18,29714,76715,76715,0.38733,52469,24246,2.164027056
5245,LP6005519-DNA_D03,19,14824,44295,44295,0.33467,31101,13194,2.357207822
5246,LP6005519-DNA_D03,2,91096,206159,206159,0.44187,140459,65700,2.137884323
5247,LP6005519-DNA_D03,20,18034,51834,51834,0.34792,36140,15694,2.302790875
5248,LP6005519-DNA_D03,21,15847,35215,35215,0.45001,24081,11134,2.162834561
5249,LP6005519-DNA_D03,22,9348,27527,27527,0.33959,19547,7980,2.449498747
5250,LP6005519-DNA_D03,3,68310,188698,188698,0.36201,127695,61003,2.093257709
5251,LP6005519-DNA_D03,4,79495,191361,191361,0.41542,129259,62102,2.081398345
5252,LP6005519-DNA_D03,5,58260,164224,164224,0.35476,111109,53115,2.091857291
5253,LP6005519-DNA_D03,6,59383,166265,166265,0.35716,113773,52492,2.167435038
5254,LP6005519-DNA_D03,7,52016,142591,142591,0.36479,97118,45473,2.135728894
5255,LP6005519-DNA_D03,8,53003,141776,141776,0.37385,93934,47842,1.963421262
5256,LP6005519-DNA_D03,9,40872,106744,106744,0.3829,71304,35440,2.011963883
5257,LP6005519-DNA_D03,MT,13,14,14,0.92857,NA,NA,NA
5258,LP6005519-DNA_D03,X,49908,50389,50389,0.99045,33892,16497,2.05443414
5259,LP6005519-DNA_D03,Y,690,700,700,0.98571,439,261,1.681992337
5260,LP6005519-DNA_D04,1,74707,193087,193087,0.38691,132979,60108,2.212334465
5261,LP6005519-DNA_D04,10,49277,127280,127280,0.38715,87588,39692,2.206691525
5262,LP6005519-DNA_D04,11,52725,127360,127360,0.41398,86323,41037,2.103540707
5263,LP6005519-DNA_D04,12,47130,121259,121259,0.38867,83472,37787,2.209013682
5264,LP6005519-DNA_D04,13,44956,103244,103244,0.43543,70269,32975,2.130978014
5265,LP6005519-DNA_D04,14,32405,83917,83917,0.38616,57131,26786,2.132867916
5266,LP6005519-DNA_D04,15,27094,73152,73152,0.37038,49788,23364,2.130970724
5267,LP6005519-DNA_D04,16,31155,68681,68681,0.45362,44854,23827,1.882486255
5268,LP6005519-DNA_D04,17,21435,59619,59619,0.35953,41883,17736,2.3614682
5269,LP6005519-DNA_D04,18,31314,78741,78741,0.39768,54146,24595,2.201504371
5270,LP6005519-DNA_D04,19,14388,41238,41238,0.3489,29069,12169,2.388774756
5271,LP6005519-DNA_D04,2,85144,216814,216814,0.39271,147005,69809,2.105817301
5272,LP6005519-DNA_D04,20,18818,51314,51314,0.36672,35715,15599,2.289569844
5273,LP6005519-DNA_D04,21,14573,35786,35786,0.40723,24388,11398,2.139673627
5274,LP6005519-DNA_D04,22,10670,25932,25932,0.41146,18326,7606,2.409413621
5275,LP6005519-DNA_D04,3,72467,188411,188411,0.38462,127331,61080,2.084659463
5276,LP6005519-DNA_D04,4,80410,198769,198769,0.40454,134456,64313,2.090650413
5277,LP6005519-DNA_D04,5,59486,166612,166612,0.35703,112331,54281,2.069434977
5278,LP6005519-DNA_D04,6,64233,166809,166809,0.38507,114023,52786,2.160099269
5279,LP6005519-DNA_D04,7,54481,139947,139947,0.3893,94944,45003,2.109726018
5280,LP6005519-DNA_D04,8,54673,144645,144645,0.37798,95731,48914,1.957128838
5281,LP6005519-DNA_D04,9,41516,107968,107968,0.38452,71766,36202,1.982376664
5282,LP6005519-DNA_D04,MT,44,47,47,0.93617,45,2,22.5
5283,LP6005519-DNA_D04,X,50864,51489,51489,0.98786,34615,16874,2.051380823
5284,LP6005519-DNA_D04,Y,704,716,716,0.98324,451,265,1.701886792
5285,LP6005519-DNA_D05,1,79436,198582,198582,0.40002,136415,62167,2.194331398
5286,LP6005519-DNA_D05,10,55114,124393,124393,0.44306,85452,38941,2.194396651
5287,LP6005519-DNA_D05,11,49952,127453,127453,0.39192,86167,41286,2.087075522
5288,LP6005519-DNA_D05,12,51251,116885,116885,0.43847,80287,36598,2.193753757
5289,LP6005519-DNA_D05,13,43623,104887,104887,0.4159,71520,33367,2.143435131
5290,LP6005519-DNA_D05,14,31660,84627,84627,0.37411,57779,26848,2.152078367
5291,LP6005519-DNA_D05,15,30320,71435,71435,0.42444,48617,22818,2.130642475
5292,LP6005519-DNA_D05,16,28236,71651,71651,0.39408,46801,24850,1.88334004
5293,LP6005519-DNA_D05,17,20716,58593,58593,0.35356,41253,17340,2.379065744
5294,LP6005519-DNA_D05,18,31457,77306,77306,0.40692,52827,24479,2.158053842
5295,LP6005519-DNA_D05,19,14102,40401,40401,0.34905,28480,11921,2.38906132
5296,LP6005519-DNA_D05,2,87273,215695,215695,0.40461,146319,69376,2.109072302
5297,LP6005519-DNA_D05,20,20700,52603,52603,0.39351,36696,15907,2.306908908
5298,LP6005519-DNA_D05,21,14607,37201,37201,0.39265,25332,11869,2.134299436
5299,LP6005519-DNA_D05,22,9136,26720,26720,0.34192,18937,7783,2.433123474
5300,LP6005519-DNA_D05,3,77215,185581,185581,0.41607,125504,60077,2.089052383
5301,LP6005519-DNA_D05,4,80460,196037,196037,0.41043,132683,63354,2.09431133
5302,LP6005519-DNA_D05,5,60103,164226,164226,0.36598,110688,53538,2.067466099
5303,LP6005519-DNA_D05,6,63212,172034,172034,0.36744,117461,54573,2.152364722
5304,LP6005519-DNA_D05,7,55865,140766,140766,0.39686,95840,44926,2.133285848
5305,LP6005519-DNA_D05,8,53780,139887,139887,0.38445,92325,47562,1.941150498
5306,LP6005519-DNA_D05,9,40867,110170,110170,0.37094,73342,36828,1.991473879
5307,LP6005519-DNA_D05,MT,46,49,49,0.93878,46,3,15.33333333
5308,LP6005519-DNA_D05,X,53046,53701,53701,0.9878,36131,17570,2.05640296
5309,LP6005519-DNA_D05,Y,645,650,650,0.99231,406,244,1.663934426
5310,LP6005519-DNA_D06,1,92660,186671,186671,0.49638,128352,58319,2.200860783
5311,LP6005519-DNA_D06,10,57152,123535,123535,0.46264,84691,38844,2.180285244
5312,LP6005519-DNA_D06,11,65309,111659,111659,0.5849,75610,36049,2.097422952
5313,LP6005519-DNA_D06,12,51146,116384,116384,0.43946,79892,36492,2.189301765
5314,LP6005519-DNA_D06,13,46840,101249,101249,0.46262,68835,32414,2.123619424
5315,LP6005519-DNA_D06,14,36923,78531,78531,0.47017,53437,25094,2.129473181
5316,LP6005519-DNA_D06,15,32779,69446,69446,0.47201,47424,22022,2.153482881
5317,LP6005519-DNA_D06,16,30955,68955,68955,0.44892,45142,23813,1.89568723
5318,LP6005519-DNA_D06,17,25408,55613,55613,0.45687,39169,16444,2.381963026
5319,LP6005519-DNA_D06,18,34096,73788,73788,0.46208,50547,23241,2.174906415
5320,LP6005519-DNA_D06,19,15078,39275,39275,0.38391,27635,11640,2.374140893
5321,LP6005519-DNA_D06,2,102029,206451,206451,0.4942,139918,66533,2.102986488
5322,LP6005519-DNA_D06,20,24227,49668,49668,0.48778,34719,14949,2.322496488
5323,LP6005519-DNA_D06,21,14093,34691,34691,0.40624,23627,11064,2.135484454
5324,LP6005519-DNA_D06,22,11508,25930,25930,0.44381,18284,7646,2.391315721
5325,LP6005519-DNA_D06,3,89401,171136,171136,0.5224,115645,55491,2.084031645
5326,LP6005519-DNA_D06,4,94762,189805,189805,0.49926,128232,61573,2.08260114
5327,LP6005519-DNA_D06,5,72615,150470,150470,0.48259,101521,48949,2.074015812
5328,LP6005519-DNA_D06,6,75294,157813,157813,0.47711,107920,49893,2.163028882
5329,LP6005519-DNA_D06,7,61222,135550,135550,0.45166,92309,43241,2.134756365
5330,LP6005519-DNA_D06,8,61067,135263,135263,0.45147,89356,45907,1.946456967
5331,LP6005519-DNA_D06,9,45775,102573,102573,0.44627,68545,34028,2.014370518
5332,LP6005519-DNA_D06,MT,30,32,32,0.9375,31,1,31
5333,LP6005519-DNA_D06,X,52002,52688,52688,0.98698,35385,17303,2.045021095
5334,LP6005519-DNA_D06,Y,653,666,666,0.98048,426,240,1.775
5335,LP6005519-DNA_E04,1,75957,198244,198244,0.38315,136380,61864,2.204513126
5336,LP6005519-DNA_E04,10,50398,129734,129734,0.38847,89240,40494,2.203783277
5337,LP6005519-DNA_E04,11,53750,126405,126405,0.42522,85650,40755,2.101582628
5338,LP6005519-DNA_E04,12,48247,123336,123336,0.39118,84568,38768,2.181386711
5339,LP6005519-DNA_E04,13,43650,105696,105696,0.41298,71875,33821,2.125158925
5340,LP6005519-DNA_E04,14,32449,82483,82483,0.3934,56168,26315,2.134448033
5341,LP6005519-DNA_E04,15,29214,73365,73365,0.3982,49934,23431,2.131108361
5342,LP6005519-DNA_E04,16,30167,73635,73635,0.40968,48193,25442,1.894230013
5343,LP6005519-DNA_E04,17,21915,56675,56675,0.38668,39952,16723,2.389045028
5344,LP6005519-DNA_E04,18,31568,77232,77232,0.40874,52905,24327,2.174744111
5345,LP6005519-DNA_E04,19,14787,42686,42686,0.34641,30111,12575,2.394512922
5346,LP6005519-DNA_E04,2,84371,216804,216804,0.38916,147168,69636,2.113389626
5347,LP6005519-DNA_E04,20,19437,52728,52728,0.36863,36754,15974,2.300863904
5348,LP6005519-DNA_E04,21,13950,36837,36837,0.3787,25099,11738,2.13826887
5349,LP6005519-DNA_E04,22,10244,27103,27103,0.37797,19211,7892,2.434237202
5350,LP6005519-DNA_E04,3,77353,189337,189337,0.40855,127819,61518,2.077749602
5351,LP6005519-DNA_E04,4,81219,196179,196179,0.414,132377,63802,2.074809567
5352,LP6005519-DNA_E04,5,58243,162513,162513,0.35839,109581,52932,2.070222172
5353,LP6005519-DNA_E04,6,60852,169780,169780,0.35842,116222,53558,2.170021285
5354,LP6005519-DNA_E04,7,53489,142029,142029,0.37661,96747,45282,2.136544322
5355,LP6005519-DNA_E04,8,56376,142515,142515,0.39558,94217,48298,1.950743302
5356,LP6005519-DNA_E04,9,42645,108343,108343,0.39361,72436,35907,2.017322528
5357,LP6005519-DNA_E04,MT,35,38,38,0.92105,36,2,18
5358,LP6005519-DNA_E04,X,51461,52080,52080,0.98811,35059,17021,2.059749721
5359,LP6005519-DNA_E04,Y,394,399,399,0.98747,245,154,1.590909091
5360,LP6005519-DNA_E05,1,78267,193706,193706,0.40405,133394,60312,2.211732325
5361,LP6005519-DNA_E05,10,51981,128932,128932,0.40317,88624,40308,2.198670239
5362,LP6005519-DNA_E05,11,52168,128266,128266,0.40672,86964,41302,2.105563895
5363,LP6005519-DNA_E05,12,50270,120835,120835,0.41602,82900,37935,2.18531699
5364,LP6005519-DNA_E05,13,45874,107194,107194,0.42795,72900,34294,2.12573628
5365,LP6005519-DNA_E05,14,33884,83040,83040,0.40804,56705,26335,2.153218151
5366,LP6005519-DNA_E05,15,28305,75137,75137,0.37671,51165,23972,2.134365093
5367,LP6005519-DNA_E05,16,28538,72891,72891,0.39152,47713,25178,1.895027405
5368,LP6005519-DNA_E05,17,22995,56824,56824,0.40467,39892,16932,2.356012284
5369,LP6005519-DNA_E05,18,32439,77124,77124,0.42061,52713,24411,2.159395355
5370,LP6005519-DNA_E05,19,13550,41800,41800,0.32416,29341,12459,2.355004414
5371,LP6005519-DNA_E05,2,90928,214587,214587,0.42373,145483,69104,2.105276106
5372,LP6005519-DNA_E05,20,19978,52364,52364,0.38152,36567,15797,2.314806609
5373,LP6005519-DNA_E05,21,14517,36215,36215,0.40086,24689,11526,2.142026722
5374,LP6005519-DNA_E05,22,10251,27272,27272,0.37588,19319,7953,2.429146234
5375,LP6005519-DNA_E05,3,76237,190215,190215,0.40079,128483,61732,2.081303052
5376,LP6005519-DNA_E05,4,83060,201500,201500,0.41221,136156,65344,2.083680215
5377,LP6005519-DNA_E05,5,61893,165512,165512,0.37395,111626,53886,2.07152136
5378,LP6005519-DNA_E05,6,71356,165740,165740,0.43053,113522,52218,2.174001302
5379,LP6005519-DNA_E05,7,55486,140293,140293,0.3955,95278,45015,2.116583361
5380,LP6005519-DNA_E05,8,55497,140628,140628,0.39464,92796,47832,1.94004014
5381,LP6005519-DNA_E05,9,43142,107892,107892,0.39986,72085,35807,2.013153853
5382,LP6005519-DNA_E05,MT,45,48,48,0.9375,45,3,15
5383,LP6005519-DNA_E05,X,52866,53510,53510,0.98796,35984,17526,2.053178135
5384,LP6005519-DNA_E05,Y,661,680,680,0.97206,419,261,1.605363985
5385,LP6005519-DNA_E06,1,87606,190727,190727,0.45933,131525,59202,2.221631026
5386,LP6005519-DNA_E06,10,55069,124666,124666,0.44173,85859,38807,2.212461669
5387,LP6005519-DNA_E06,11,55273,119743,119743,0.4616,81172,38571,2.104482642
5388,LP6005519-DNA_E06,12,50853,118684,118684,0.42847,81337,37347,2.177872386
5389,LP6005519-DNA_E06,13,47260,100910,100910,0.46834,68673,32237,2.130254056
5390,LP6005519-DNA_E06,14,36000,82516,82516,0.43628,56241,26275,2.140475737
5391,LP6005519-DNA_E06,15,31276,70189,70189,0.4456,47715,22474,2.12312005
5392,LP6005519-DNA_E06,16,31511,72392,72392,0.43528,47587,24805,1.918443862
5393,LP6005519-DNA_E06,17,24517,56551,56551,0.43354,39913,16638,2.398906119
5394,LP6005519-DNA_E06,18,33258,75116,75116,0.44276,51503,23613,2.181129039
5395,LP6005519-DNA_E06,19,16190,38519,38519,0.42031,27068,11451,2.363811021
5396,LP6005519-DNA_E06,2,92531,210215,210215,0.44017,142983,67232,2.126710495
5397,LP6005519-DNA_E06,20,22960,51376,51376,0.4469,35799,15577,2.298196058
5398,LP6005519-DNA_E06,21,14867,35904,35904,0.41408,24493,11411,2.146437648
5399,LP6005519-DNA_E06,22,12104,28375,28375,0.42657,20039,8336,2.403910749
5400,LP6005519-DNA_E06,3,83012,181856,181856,0.45647,122716,59140,2.075008455
5401,LP6005519-DNA_E06,4,90693,190016,190016,0.47729,128306,61710,2.079176795
5402,LP6005519-DNA_E06,5,60914,153754,153754,0.39618,103833,49921,2.079946315
5403,LP6005519-DNA_E06,6,67865,162094,162094,0.41868,110971,51123,2.170666823
5404,LP6005519-DNA_E06,7,58593,139757,139757,0.41925,95055,44702,2.126414926
5405,LP6005519-DNA_E06,8,62476,133549,133549,0.46781,88461,45088,1.961963272
5406,LP6005519-DNA_E06,9,53063,98584,98584,0.53825,66114,32470,2.036156452
5407,LP6005519-DNA_E06,MT,40,44,44,0.90909,42,2,21
5408,LP6005519-DNA_E06,X,33957,69431,69431,0.48908,46910,22521,2.082944807
5409,LP6005519-DNA_F03,1,77360,193572,193572,0.39964,133490,60082,2.221796878
5410,LP6005519-DNA_F03,10,50656,130140,130140,0.38924,89502,40638,2.202421379
5411,LP6005519-DNA_F03,11,53117,130869,130869,0.40588,88634,42235,2.098591216
5412,LP6005519-DNA_F03,12,47839,121954,121954,0.39227,83620,38334,2.181353368
5413,LP6005519-DNA_F03,13,45175,105076,105076,0.42993,71695,33381,2.147778676
5414,LP6005519-DNA_F03,14,32772,86822,86822,0.37746,59287,27535,2.153150536
5415,LP6005519-DNA_F03,15,30217,74780,74780,0.40408,51093,23687,2.157005953
5416,LP6005519-DNA_F03,16,27453,73752,73752,0.37223,48136,25616,1.879138039
5417,LP6005519-DNA_F03,17,22772,60482,60482,0.37651,42750,17732,2.410895556
5418,LP6005519-DNA_F03,18,30541,79331,79331,0.38498,54557,24774,2.202187778
5419,LP6005519-DNA_F03,19,14171,43180,43180,0.32818,30250,12930,2.339520495
5420,LP6005519-DNA_F03,2,84384,218622,218622,0.38598,148606,70016,2.122457724
5421,LP6005519-DNA_F03,20,18519,52307,52307,0.35404,36426,15881,2.293684277
5422,LP6005519-DNA_F03,21,14713,37757,37757,0.38968,25833,11924,2.166470983
5423,LP6005519-DNA_F03,22,9768,27745,27745,0.35206,19669,8076,2.435487865
5424,LP6005519-DNA_F03,3,69342,186149,186149,0.37251,125788,60361,2.083928364
5425,LP6005519-DNA_F03,4,78399,196743,196743,0.39848,132776,63967,2.07569528
5426,LP6005519-DNA_F03,5,61080,163572,163572,0.37341,110519,53053,2.08318097
5427,LP6005519-DNA_F03,6,60751,167100,167100,0.36356,114253,52847,2.161958105
5428,LP6005519-DNA_F03,7,54627,145092,145092,0.3765,98721,46371,2.128938345
5429,LP6005519-DNA_F03,8,53954,143292,143292,0.37653,95016,48276,1.968182948
5430,LP6005519-DNA_F03,9,41958,107276,107276,0.39112,71690,35586,2.014556286
5431,LP6005519-DNA_F03,MT,32,33,33,0.9697,29,4,7.25
5432,LP6005519-DNA_F03,X,50613,51260,51260,0.98738,34569,16691,2.07111617
5433,LP6005519-DNA_F03,Y,155,165,165,0.93939,107,58,1.844827586
5434,LP6005519-DNA_F04,1,76979,197465,197465,0.38984,135852,61613,2.204924285
5435,LP6005519-DNA_F04,10,52266,130877,130877,0.39935,89831,41046,2.18854456
5436,LP6005519-DNA_F04,11,50871,127220,127220,0.39987,86241,40979,2.104516948
5437,LP6005519-DNA_F04,12,48535,120310,120310,0.40342,82657,37653,2.195230128
5438,LP6005519-DNA_F04,13,43509,104973,104973,0.41448,71516,33457,2.137549691
5439,LP6005519-DNA_F04,14,34168,85122,85122,0.4014,58257,26865,2.168509213
5440,LP6005519-DNA_F04,15,30688,73987,73987,0.41478,50465,23522,2.145438313
5441,LP6005519-DNA_F04,16,29039,74152,74152,0.39161,48463,25689,1.886527307
5442,LP6005519-DNA_F04,17,22445,59016,59016,0.38032,41567,17449,2.382199553
5443,LP6005519-DNA_F04,18,32347,77486,77486,0.41746,53144,24342,2.183222414
5444,LP6005519-DNA_F04,19,14684,43744,43744,0.33568,30874,12870,2.398912199
5445,LP6005519-DNA_F04,2,87038,218756,218756,0.39788,148780,69976,2.12615754
5446,LP6005519-DNA_F04,20,19080,53901,53901,0.35398,37626,16275,2.311889401
5447,LP6005519-DNA_F04,21,15951,37110,37110,0.42983,25320,11790,2.147582697
5448,LP6005519-DNA_F04,22,10925,27449,27449,0.39801,19413,8036,2.415754107
5449,LP6005519-DNA_F04,3,74188,190720,190720,0.38899,128648,62072,2.072560897
5450,LP6005519-DNA_F04,4,80132,199298,199298,0.40207,134577,64721,2.079340554
5451,LP6005519-DNA_F04,5,59397,161704,161704,0.36732,109058,52646,2.0715344
5452,LP6005519-DNA_F04,6,65867,165889,165889,0.39705,113359,52530,2.157985913
5453,LP6005519-DNA_F04,7,55859,146454,146454,0.38141,99697,46757,2.132236884
5454,LP6005519-DNA_F04,8,53802,143209,143209,0.37569,94797,48412,1.958130216
5455,LP6005519-DNA_F04,9,41792,107826,107826,0.38759,72066,35760,2.015268456
5456,LP6005519-DNA_F04,MT,31,33,33,0.93939,NA,NA,NA
5457,LP6005519-DNA_F04,X,51477,52058,52058,0.98884,35067,16991,2.063857336
5458,LP6005519-DNA_F04,Y,669,683,683,0.9795,428,255,1.678431373
5459,LP6005519-DNA_F06,1,88381,191532,191532,0.46144,131970,59562,2.215674423
5460,LP6005519-DNA_F06,10,57230,126359,126359,0.45292,86760,39599,2.190964418
5461,LP6005519-DNA_F06,11,53186,125572,125572,0.42355,85016,40556,2.096261959
5462,LP6005519-DNA_F06,12,53503,121575,121575,0.44008,83598,37977,2.201279722
5463,LP6005519-DNA_F06,13,46594,100489,100489,0.46367,68468,32021,2.138221792
5464,LP6005519-DNA_F06,14,37661,78492,78492,0.47981,53485,25007,2.138801136
5465,LP6005519-DNA_F06,15,31111,71554,71554,0.43479,48545,23009,2.10982659
5466,LP6005519-DNA_F06,16,33260,70294,70294,0.47316,46125,24169,1.908436427
5467,LP6005519-DNA_F06,17,25269,56082,56082,0.45057,39412,16670,2.364247151
5468,LP6005519-DNA_F06,18,40273,73492,73492,0.54799,50196,23296,2.15470467
5469,LP6005519-DNA_F06,19,16219,40690,40690,0.3986,28723,11967,2.400183839
5470,LP6005519-DNA_F06,2,100107,206624,206624,0.48449,140315,66309,2.116077757
5471,LP6005519-DNA_F06,20,23061,52071,52071,0.44288,36332,15739,2.308405871
5472,LP6005519-DNA_F06,21,14587,34679,34679,0.42063,23585,11094,2.125923923
5473,LP6005519-DNA_F06,22,11608,26791,26791,0.43328,18899,7892,2.394703497
5474,LP6005519-DNA_F06,3,86537,179758,179758,0.48141,121249,58509,2.072313661
5475,LP6005519-DNA_F06,4,90125,192288,192288,0.4687,129681,62607,2.071349849
5476,LP6005519-DNA_F06,5,64604,154967,154967,0.41689,104536,50431,2.072852016
5477,LP6005519-DNA_F06,6,77092,159010,159010,0.48482,108725,50285,2.162175599
5478,LP6005519-DNA_F06,7,59050,139001,139001,0.42482,94461,44540,2.120812753
5479,LP6005519-DNA_F06,8,60544,138561,138561,0.43695,91697,46864,1.95666183
5480,LP6005519-DNA_F06,9,45593,104482,104482,0.43637,69781,34701,2.010921875
5481,LP6005519-DNA_F06,MT,23,27,27,0.85185,25,2,12.5
5482,LP6005519-DNA_F06,X,34755,73611,73611,0.47214,49617,23994,2.067891973
5483,LP6005519-DNA_G02,1,89073,181088,181088,0.49188,124421,56667,2.19565179
5484,LP6005519-DNA_G02,10,56198,113407,113407,0.49554,77584,35823,2.165759428
5485,LP6005519-DNA_G02,11,55221,118994,118994,0.46407,80314,38680,2.076370217
5486,LP6005519-DNA_G02,12,54060,109650,109650,0.49302,74886,34764,2.154124957
5487,LP6005519-DNA_G02,13,52499,101961,101961,0.51489,69204,32757,2.112647678
5488,LP6005519-DNA_G02,14,36661,77082,77082,0.47561,52395,24687,2.122372099
5489,LP6005519-DNA_G02,15,34750,66704,66704,0.52096,45289,21415,2.114826057
5490,LP6005519-DNA_G02,16,29201,61123,61123,0.47774,40046,21077,1.899985766
5491,LP6005519-DNA_G02,17,21075,48478,48478,0.43473,33946,14532,2.335948252
5492,LP6005519-DNA_G02,18,34642,77599,77599,0.44642,53000,24599,2.154559128
5493,LP6005519-DNA_G02,19,14600,33185,33185,0.43996,23139,10046,2.303304798
5494,LP6005519-DNA_G02,2,101213,206224,206224,0.49079,139390,66834,2.085615106
5495,LP6005519-DNA_G02,20,20053,46122,46122,0.43478,31988,14134,2.263195132
5496,LP6005519-DNA_G02,21,15343,33025,33025,0.46459,22467,10558,2.127959841
5497,LP6005519-DNA_G02,22,9463,23781,23781,0.39792,16811,6970,2.411908178
5498,LP6005519-DNA_G02,3,86460,177413,177413,0.48734,119367,58046,2.05642077
5499,LP6005519-DNA_G02,4,92173,196210,196210,0.46977,132160,64050,2.063387978
5500,LP6005519-DNA_G02,5,72634,152615,152615,0.47593,102612,50003,2.052116873
5501,LP6005519-DNA_G02,6,72674,161869,161869,0.44897,110401,51468,2.145041579
5502,LP6005519-DNA_G02,7,61170,135449,135449,0.45161,91767,43682,2.100796667
5503,LP6005519-DNA_G02,8,64010,130181,130181,0.4917,85849,44332,1.93650185
5504,LP6005519-DNA_G02,9,47318,102691,102691,0.46078,68419,34272,1.996352708
5505,LP6005519-DNA_G02,MT,31,34,34,0.91176,31,3,10.33333333
5506,LP6005519-DNA_G02,X,37183,70298,70298,0.52893,47259,23039,2.051260905
5507,LP6005519-DNA_G03,1,78080,201320,201320,0.38784,138716,62604,2.21576896
5508,LP6005519-DNA_G03,10,52835,128776,128776,0.41029,88561,40215,2.202188238
5509,LP6005519-DNA_G03,11,51214,130044,130044,0.39382,88204,41840,2.108126195
5510,LP6005519-DNA_G03,12,44822,121673,121673,0.36838,83394,38279,2.178583558
5511,LP6005519-DNA_G03,13,43296,105438,105438,0.41063,71820,33618,2.136355524
5512,LP6005519-DNA_G03,14,31429,85202,85202,0.36888,58172,27030,2.152127266
5513,LP6005519-DNA_G03,15,30137,76902,76902,0.39189,52413,24489,2.140267059
5514,LP6005519-DNA_G03,16,28323,75775,75775,0.37378,49563,26212,1.890851518
5515,LP6005519-DNA_G03,17,22595,58926,58926,0.38345,41518,17408,2.384995404
5516,LP6005519-DNA_G03,18,30495,79045,79045,0.38579,54176,24869,2.178455105
5517,LP6005519-DNA_G03,19,14400,42368,42368,0.33988,29995,12373,2.424230179
5518,LP6005519-DNA_G03,2,87618,222301,222301,0.39414,151004,71297,2.117957277
5519,LP6005519-DNA_G03,20,18925,53649,53649,0.35276,37365,16284,2.29458364
5520,LP6005519-DNA_G03,21,14295,36137,36137,0.39558,24620,11517,2.137709473
5521,LP6005519-DNA_G03,22,9952,28342,28342,0.35114,19967,8375,2.384119403
5522,LP6005519-DNA_G03,3,69219,192627,192627,0.35934,129930,62697,2.072347959
5523,LP6005519-DNA_G03,4,81051,199646,199646,0.40597,134942,64704,2.085527943
5524,LP6005519-DNA_G03,5,59741,167603,167603,0.35644,113329,54274,2.088090062
5525,LP6005519-DNA_G03,6,60833,167109,167109,0.36403,114250,52859,2.161410545
5526,LP6005519-DNA_G03,7,52039,144187,144187,0.36091,97968,46219,2.119647764
5527,LP6005519-DNA_G03,8,52663,144629,144629,0.36412,95488,49141,1.9431432
5528,LP6005519-DNA_G03,9,41415,109172,109172,0.37936,72846,36326,2.005340527
5529,LP6005519-DNA_G03,MT,32,35,35,0.91429,34,1,34
5530,LP6005519-DNA_G03,X,50094,50718,50718,0.9877,34059,16659,2.044480461
5531,LP6005519-DNA_G03,Y,448,471,471,0.95117,295,176,1.676136364
5532,LP6005519-DNA_G04,1,75706,193409,193409,0.39143,133320,60089,2.218708915
5533,LP6005519-DNA_G04,10,50663,131324,131324,0.38579,90292,41032,2.200526418
5534,LP6005519-DNA_G04,11,52221,128282,128282,0.40708,86898,41384,2.099797023
5535,LP6005519-DNA_G04,12,48930,121949,121949,0.40123,83589,38360,2.179066736
5536,LP6005519-DNA_G04,13,43592,103796,103796,0.41998,70723,33073,2.138390832
5537,LP6005519-DNA_G04,14,34778,81564,81564,0.42639,55598,25966,2.141184626
5538,LP6005519-DNA_G04,15,29536,73015,73015,0.40452,49764,23251,2.140295041
5539,LP6005519-DNA_G04,16,28395,75029,75029,0.37845,49138,25891,1.897879572
5540,LP6005519-DNA_G04,17,22798,60510,60510,0.37676,42688,17822,2.395241836
5541,LP6005519-DNA_G04,18,30677,79626,79626,0.38526,54471,25155,2.165414431
5542,LP6005519-DNA_G04,19,15466,41562,41562,0.37212,29332,12230,2.398364677
5543,LP6005519-DNA_G04,2,86885,220786,220786,0.39353,149761,71025,2.108567406
5544,LP6005519-DNA_G04,20,19254,52551,52551,0.36639,36568,15983,2.287930927
5545,LP6005519-DNA_G04,21,15152,36638,36638,0.41356,24897,11741,2.120517843
5546,LP6005519-DNA_G04,22,9763,28867,28867,0.33821,20438,8429,2.424724167
5547,LP6005519-DNA_G04,3,73441,189764,189764,0.38701,128087,61677,2.076738492
5548,LP6005519-DNA_G04,4,78566,198339,198339,0.39612,133913,64426,2.078555242
5549,LP6005519-DNA_G04,5,63541,161152,161152,0.39429,108796,52356,2.078004431
5550,LP6005519-DNA_G04,6,65778,167999,167999,0.39154,115114,52885,2.17668526
5551,LP6005519-DNA_G04,7,53434,142557,142557,0.37483,96641,45916,2.104734733
5552,LP6005519-DNA_G04,8,52520,143019,143019,0.36722,94507,48512,1.94811593
5553,LP6005519-DNA_G04,9,39475,111725,111725,0.35332,74654,37071,2.013811335
5554,LP6005519-DNA_G04,MT,16,17,17,0.94118,NA,NA,NA
5555,LP6005519-DNA_G04,X,52523,53153,53153,0.98815,35622,17531,2.031943415
5556,LP6005519-DNA_G04,Y,431,440,440,0.97955,287,153,1.875816993
5557,LP6005519-DNA_H03,1,78470,197676,197676,0.39696,136536,61140,2.233169774
5558,LP6005519-DNA_H03,10,50687,132675,132675,0.38204,91183,41492,2.197604357
5559,LP6005519-DNA_H03,11,51461,128218,128218,0.40136,86786,41432,2.094661131
5560,LP6005519-DNA_H03,12,46936,122408,122408,0.38344,84184,38224,2.202385936
5561,LP6005519-DNA_H03,13,44963,102522,102522,0.43857,69737,32785,2.127100808
5562,LP6005519-DNA_H03,14,33281,84857,84857,0.3922,58007,26850,2.160409683
5563,LP6005519-DNA_H03,15,29572,73880,73880,0.40027,50263,23617,2.128255071
5564,LP6005519-DNA_H03,16,28435,74980,74980,0.37923,49087,25893,1.895763334
5565,LP6005519-DNA_H03,17,21755,60114,60114,0.3619,42483,17631,2.409562702
5566,LP6005519-DNA_H03,18,32513,78624,78624,0.41353,53852,24772,2.173906023
5567,LP6005519-DNA_H03,19,14890,43116,43116,0.34535,30419,12697,2.395762779
5568,LP6005519-DNA_H03,2,83282,222501,222501,0.3743,150948,71553,2.109597082
5569,LP6005519-DNA_H03,20,19094,54073,54073,0.35312,37691,16382,2.300756928
5570,LP6005519-DNA_H03,21,13689,35919,35919,0.38111,24384,11535,2.113914174
5571,LP6005519-DNA_H03,22,9533,28150,28150,0.33865,19949,8201,2.432508231
5572,LP6005519-DNA_H03,3,72116,189586,189586,0.38039,128147,61439,2.085759859
5573,LP6005519-DNA_H03,4,78616,197555,197555,0.39794,133495,64060,2.083905713
5574,LP6005519-DNA_H03,5,59167,162694,162694,0.36367,109864,52830,2.079575998
5575,LP6005519-DNA_H03,6,62017,172189,172189,0.36017,117961,54228,2.175278454
5576,LP6005519-DNA_H03,7,54028,143062,143062,0.37765,97524,45538,2.14159603
5577,LP6005519-DNA_H03,8,55153,144209,144209,0.38245,95461,48748,1.958254698
5578,LP6005519-DNA_H03,9,40115,109946,109946,0.36486,73474,36472,2.014531696
5579,LP6005519-DNA_H03,MT,48,50,50,0.96,47,3,15.66666667
5580,LP6005519-DNA_H03,X,51614,52478,52478,0.98354,35257,17221,2.047325939
5581,LP6005519-DNA_H03,Y,711,724,724,0.98204,446,278,1.604316547
5582,LP6005519-DNA_H04,1,76076,195369,195369,0.3894,134611,60758,2.215527173
5583,LP6005519-DNA_H04,10,50040,129145,129145,0.38747,88700,40445,2.193101743
5584,LP6005519-DNA_H04,11,52310,126496,126496,0.41353,85759,40737,2.105186931
5585,LP6005519-DNA_H04,12,45174,123578,123578,0.36555,84878,38700,2.193229974
5586,LP6005519-DNA_H04,13,43804,104729,104729,0.41826,71324,33405,2.135129472
5587,LP6005519-DNA_H04,14,30393,83998,83998,0.36183,57410,26588,2.159244772
5588,LP6005519-DNA_H04,15,29013,73171,73171,0.39651,49670,23501,2.113527084
5589,LP6005519-DNA_H04,16,28194,73006,73006,0.38619,47853,25153,1.902476842
5590,LP6005519-DNA_H04,17,22216,57464,57464,0.38661,40485,16979,2.384416043
5591,LP6005519-DNA_H04,18,31617,78182,78182,0.4044,53695,24487,2.192796178
5592,LP6005519-DNA_H04,19,15233,41488,41488,0.36717,29181,12307,2.371089624
5593,LP6005519-DNA_H04,2,86130,216827,216827,0.39723,146989,69838,2.104713766
5594,LP6005519-DNA_H04,20,18233,52480,52480,0.34743,36599,15881,2.304577797
5595,LP6005519-DNA_H04,21,13543,36640,36640,0.36962,24938,11702,2.131088703
5596,LP6005519-DNA_H04,22,9641,26466,26466,0.36428,18700,7766,2.407932011
5597,LP6005519-DNA_H04,3,73047,188877,188877,0.38674,127586,61291,2.081643308
5598,LP6005519-DNA_H04,4,79683,197246,197246,0.40398,133227,64019,2.081054062
5599,LP6005519-DNA_H04,5,62433,162014,162014,0.38536,109001,53013,2.056118311
5600,LP6005519-DNA_H04,6,65794,165963,165963,0.39644,113563,52400,2.167232824
5601,LP6005519-DNA_H04,7,52367,141298,141298,0.37061,96007,45291,2.119780972
5602,LP6005519-DNA_H04,8,53541,142508,142508,0.37571,94261,48247,1.95371733
5603,LP6005519-DNA_H04,9,42359,107141,107141,0.39536,71416,35725,1.999048286
5604,LP6005519-DNA_H04,MT,32,35,35,0.91429,NA,NA,NA
5605,LP6005519-DNA_H04,X,51992,52634,52634,0.9878,35367,17267,2.048242312
5606,LP6005519-DNA_H04,Y,679,688,688,0.98692,416,272,1.529411765
5607,LP6005592-DNA_A02,1,77436,198683,198683,0.38975,136715,61968,2.206219339
5608,LP6005592-DNA_A02,10,50917,128193,128193,0.39719,88370,39823,2.219069382
5609,LP6005592-DNA_A02,11,50285,126913,126913,0.39622,86070,40843,2.107337855
5610,LP6005592-DNA_A02,12,48365,119494,119494,0.40475,82334,37160,2.215662002
5611,LP6005592-DNA_A02,13,46176,104397,104397,0.44231,71095,33302,2.134856765
5612,LP6005592-DNA_A02,14,31663,82239,82239,0.38501,56073,26166,2.142971795
5613,LP6005592-DNA_A02,15,31211,74126,74126,0.42105,50575,23551,2.147467199
5614,LP6005592-DNA_A02,16,28811,72912,72912,0.39515,47812,25100,1.904860558
5615,LP6005592-DNA_A02,17,21724,60992,60992,0.35618,43040,17952,2.397504456
5616,LP6005592-DNA_A02,18,33732,75699,75699,0.44561,51807,23892,2.168382722
5617,LP6005592-DNA_A02,19,16106,41856,41856,0.3848,29530,12326,2.395748824
5618,LP6005592-DNA_A02,2,87988,218175,218175,0.40329,147973,70202,2.107817441
5619,LP6005592-DNA_A02,20,20670,52036,52036,0.39722,36098,15938,2.264901493
5620,LP6005592-DNA_A02,21,14591,37566,37566,0.38841,25635,11931,2.148604476
5621,LP6005592-DNA_A02,22,10104,29221,29221,0.34578,20681,8540,2.421662763
5622,LP6005592-DNA_A02,3,72388,184319,184319,0.39273,124411,59908,2.076700941
5623,LP6005592-DNA_A02,4,79048,196448,196448,0.40239,132674,63774,2.080377583
5624,LP6005592-DNA_A02,5,62105,162317,162317,0.38262,109397,52920,2.067214664
5625,LP6005592-DNA_A02,6,62122,166160,166160,0.37387,113601,52559,2.16139957
5626,LP6005592-DNA_A02,7,50827,144418,144418,0.35194,98308,46110,2.132032097
5627,LP6005592-DNA_A02,8,54636,143509,143509,0.38071,94645,48864,1.936906516
5628,LP6005592-DNA_A02,9,40212,109009,109009,0.36889,72832,36177,2.013212815
5629,LP6005592-DNA_A02,MT,7,9,9,0.77778,8,1,8
5630,LP6005592-DNA_A02,X,1852,3393,3393,0.54583,2310,1083,2.132963989
5631,LP6005592-DNA_A04,1,72085,186958,186958,0.38557,128820,58138,2.215762496
5632,LP6005592-DNA_A04,10,45156,123265,123265,0.36633,84706,38559,2.196789336
5633,LP6005592-DNA_A04,11,49534,119691,119691,0.41385,81069,38622,2.099036818
5634,LP6005592-DNA_A04,12,45269,114242,114242,0.39626,78236,36006,2.172860079
5635,LP6005592-DNA_A04,13,41454,99404,99404,0.41703,67575,31829,2.123063873
5636,LP6005592-DNA_A04,14,30651,81657,81657,0.37536,55729,25928,2.149375193
5637,LP6005592-DNA_A04,15,27674,71276,71276,0.38827,48335,22941,2.106926464
5638,LP6005592-DNA_A04,16,25306,68943,68943,0.36706,45133,23810,1.895548089
5639,LP6005592-DNA_A04,17,20034,57545,57545,0.34814,40615,16930,2.398995865
5640,LP6005592-DNA_A04,18,31305,73354,73354,0.42677,50183,23171,2.165767554
5641,LP6005592-DNA_A04,19,13174,38074,38074,0.34601,26775,11299,2.369678733
5642,LP6005592-DNA_A04,2,81343,209858,209858,0.38761,142289,67569,2.105832556
5643,LP6005592-DNA_A04,20,17653,50642,50642,0.34858,35335,15307,2.308420984
5644,LP6005592-DNA_A04,21,14033,35397,35397,0.39645,24130,11267,2.141652614
5645,LP6005592-DNA_A04,22,8546,25443,25443,0.33589,17983,7460,2.410589812
5646,LP6005592-DNA_A04,3,68817,177486,177486,0.38773,119808,57678,2.077187142
5647,LP6005592-DNA_A04,4,74235,188402,188402,0.39402,127309,61093,2.083855761
5648,LP6005592-DNA_A04,5,55923,151797,151797,0.36841,102350,49447,2.069893017
5649,LP6005592-DNA_A04,6,57207,155991,155991,0.36673,106551,49440,2.155157767
5650,LP6005592-DNA_A04,7,48471,132998,132998,0.36445,90483,42515,2.128260614
5651,LP6005592-DNA_A04,8,50485,134072,134072,0.37655,88651,45421,1.951762401
5652,LP6005592-DNA_A04,9,38490,103383,103383,0.3723,68967,34416,2.003922594
5653,LP6005592-DNA_A04,MT,36,37,37,0.97297,35,2,17.5
5654,LP6005592-DNA_A04,X,26647,71232,71232,0.37409,47979,23253,2.063346665
5655,LP6005592-DNA_B01,1,78435,195355,195355,0.4015,134935,60420,2.233283681
5656,LP6005592-DNA_B01,10,50289,131631,131631,0.38205,90515,41116,2.201454422
5657,LP6005592-DNA_B01,11,53736,128094,128094,0.4195,87096,40998,2.124396312
5658,LP6005592-DNA_B01,12,47347,120748,120748,0.39211,83098,37650,2.207118194
5659,LP6005592-DNA_B01,13,45278,105073,105073,0.43092,71580,33493,2.137162989
5660,LP6005592-DNA_B01,14,32714,82441,82441,0.39682,56316,26125,2.155636364
5661,LP6005592-DNA_B01,15,29726,72847,72847,0.40806,49667,23180,2.142666091
5662,LP6005592-DNA_B01,16,30647,73891,73891,0.41476,48474,25417,1.907148759
5663,LP6005592-DNA_B01,17,24799,60841,60841,0.4076,43110,17731,2.43133495
5664,LP6005592-DNA_B01,18,32136,76443,76443,0.42039,52365,24078,2.174806878
5665,LP6005592-DNA_B01,19,15987,43977,43977,0.36353,31015,12962,2.392763462
5666,LP6005592-DNA_B01,2,85035,215977,215977,0.39372,146920,69057,2.127517848
5667,LP6005592-DNA_B01,20,18597,51928,51928,0.35813,36270,15658,2.316387789
5668,LP6005592-DNA_B01,21,13556,37382,37382,0.36263,25609,11773,2.175231462
5669,LP6005592-DNA_B01,22,10683,29247,29247,0.36527,20681,8566,2.414312398
5670,LP6005592-DNA_B01,3,71629,185592,185592,0.38595,125515,60077,2.089235481
5671,LP6005592-DNA_B01,4,80778,197293,197293,0.40943,133502,63791,2.09280306
5672,LP6005592-DNA_B01,5,57299,165335,165335,0.34656,111518,53817,2.072170504
5673,LP6005592-DNA_B01,6,61466,165514,165514,0.37136,113539,51975,2.184492544
5674,LP6005592-DNA_B01,7,52652,139289,139289,0.37801,94912,44377,2.138765577
5675,LP6005592-DNA_B01,8,52725,139903,139903,0.37687,92847,47056,1.973117137
5676,LP6005592-DNA_B01,9,41478,109837,109837,0.37763,73571,36266,2.028649424
5677,LP6005592-DNA_B01,MT,19,20,20,0.95,19,1,19
5678,LP6005592-DNA_B01,X,28041,72522,72522,0.38666,48928,23594,2.073747563
5679,LP6005592-DNA_B02,1,69919,189963,189963,0.36807,130441,59522,2.191475421
5680,LP6005592-DNA_B02,10,45036,121196,121196,0.3716,83281,37915,2.196518528
5681,LP6005592-DNA_B02,11,47894,121002,121002,0.39581,81874,39128,2.092465753
5682,LP6005592-DNA_B02,12,42177,115398,115398,0.36549,78925,36473,2.163929482
5683,LP6005592-DNA_B02,13,39562,99573,99573,0.39732,67591,31982,2.113407542
5684,LP6005592-DNA_B02,14,28367,81436,81436,0.34833,55381,26055,2.125542122
5685,LP6005592-DNA_B02,15,24644,71964,71964,0.34245,48864,23100,2.115324675
5686,LP6005592-DNA_B02,16,24568,69105,69105,0.35552,45062,24043,1.874225346
5687,LP6005592-DNA_B02,17,18756,54577,54577,0.34366,38316,16261,2.35631265
5688,LP6005592-DNA_B02,18,27077,80433,80433,0.33664,55031,25402,2.16640422
5689,LP6005592-DNA_B02,19,12801,38882,38882,0.32923,27144,11738,2.312489351
5690,LP6005592-DNA_B02,2,79916,206111,206111,0.38773,139553,66558,2.096712642
5691,LP6005592-DNA_B02,20,16847,49830,49830,0.33809,34461,15369,2.242240874
5692,LP6005592-DNA_B02,21,12872,33635,33635,0.3827,22876,10759,2.126219909
5693,LP6005592-DNA_B02,22,7877,25551,25551,0.30829,18036,7515,2.4
5694,LP6005592-DNA_B02,3,63381,178491,178491,0.35509,120342,58149,2.069545478
5695,LP6005592-DNA_B02,4,71461,192121,192121,0.37196,129621,62500,2.073936
5696,LP6005592-DNA_B02,5,51195,156196,156196,0.32776,105226,50970,2.064469296
5697,LP6005592-DNA_B02,6,53414,159078,159078,0.33577,108625,50453,2.152993875
5698,LP6005592-DNA_B02,7,47442,136336,136336,0.34798,92786,43550,2.130562572
5699,LP6005592-DNA_B02,8,47590,148790,148790,0.31985,98362,50428,1.950543349
5700,LP6005592-DNA_B02,9,35972,100755,100755,0.35702,67235,33520,2.005817422
5701,LP6005592-DNA_B02,MT,24,30,30,0.8,28,2,14
5702,LP6005592-DNA_B02,X,47462,49317,49317,0.96239,32603,16714,1.950640182
5703,LP6005592-DNA_B02,Y,605,681,681,0.8884,399,282,1.414893617
5704,LP6005592-DNA_B03,1,77272,203628,203628,0.37948,140426,63202,2.221860068
5705,LP6005592-DNA_B03,10,50692,133204,133204,0.38056,91786,41418,2.216089623
5706,LP6005592-DNA_B03,11,51240,132771,132771,0.38593,89877,42894,2.095328018
5707,LP6005592-DNA_B03,12,47695,124923,124923,0.3818,85893,39030,2.200691776
5708,LP6005592-DNA_B03,13,45030,106431,106431,0.42309,72529,33902,2.139372308
5709,LP6005592-DNA_B03,14,31712,89747,89747,0.35335,61474,28273,2.174300569
5710,LP6005592-DNA_B03,15,29103,75454,75454,0.38571,51432,24022,2.141037382
5711,LP6005592-DNA_B03,16,28143,76247,76247,0.3691,50097,26150,1.915755258
5712,LP6005592-DNA_B03,17,22480,63516,63516,0.35393,44948,18568,2.420723826
5713,LP6005592-DNA_B03,18,29891,78703,78703,0.37979,54060,24643,2.193726413
5714,LP6005592-DNA_B03,19,17882,44040,44040,0.40604,31025,13015,2.383787937
5715,LP6005592-DNA_B03,2,83597,220762,220762,0.37867,149895,70867,2.115159383
5716,LP6005592-DNA_B03,20,19171,56193,56193,0.34116,39226,16967,2.31189957
5717,LP6005592-DNA_B03,21,15441,37751,37751,0.40902,25799,11952,2.15855087
5718,LP6005592-DNA_B03,22,10686,29807,29807,0.35851,21123,8684,2.432404422
5719,LP6005592-DNA_B03,3,75760,184329,184329,0.411,124435,59894,2.07758707
5720,LP6005592-DNA_B03,4,76226,198651,198651,0.38372,134310,64341,2.087471441
5721,LP6005592-DNA_B03,5,61349,163050,163050,0.37626,110304,52746,2.091229667
5722,LP6005592-DNA_B03,6,62563,172586,172586,0.3625,118178,54408,2.172070284
5723,LP6005592-DNA_B03,7,57521,137957,137957,0.41695,93854,44103,2.128063851
5724,LP6005592-DNA_B03,8,56571,140875,140875,0.40157,93161,47714,1.952487739
5725,LP6005592-DNA_B03,9,44926,107628,107628,0.41742,72059,35569,2.025893334
5726,LP6005592-DNA_B03,MT,37,38,38,0.97368,35,3,11.66666667
5727,LP6005592-DNA_B03,X,54437,55132,55132,0.98739,37013,18119,2.04277278
5728,LP6005592-DNA_B03,Y,993,1011,1011,0.9822,647,364,1.777472527
5729,LP6005592-DNA_B04,1,79872,201885,201885,0.39563,139310,62575,2.226288454
5730,LP6005592-DNA_B04,10,49239,131614,131614,0.37412,90684,40930,2.215587589
5731,LP6005592-DNA_B04,11,53659,135261,135261,0.39671,91865,43396,2.116900175
5732,LP6005592-DNA_B04,12,47509,123777,123777,0.38383,85005,38772,2.192432683
5733,LP6005592-DNA_B04,13,45603,103845,103845,0.43914,70804,33041,2.14291335
5734,LP6005592-DNA_B04,14,31729,86219,86219,0.368,58969,27250,2.164
5735,LP6005592-DNA_B04,15,31768,75234,75234,0.42226,51259,23975,2.13801877
5736,LP6005592-DNA_B04,16,29584,78474,78474,0.37699,51414,27060,1.9
5737,LP6005592-DNA_B04,17,23206,61809,61809,0.37545,43681,18128,2.409587379
5738,LP6005592-DNA_B04,18,32492,76829,76829,0.42291,52677,24152,2.18106161
5739,LP6005592-DNA_B04,19,15487,45577,45577,0.3398,32282,13295,2.428130876
5740,LP6005592-DNA_B04,2,88363,221264,221264,0.39936,150408,70856,2.122727786
5741,LP6005592-DNA_B04,20,21265,54378,54378,0.39106,37810,16568,2.282110092
5742,LP6005592-DNA_B04,21,14793,37193,37193,0.39774,25380,11813,2.148480488
5743,LP6005592-DNA_B04,22,10980,29949,29949,0.36662,21312,8637,2.467523446
5744,LP6005592-DNA_B04,3,75603,190168,190168,0.39756,128424,61744,2.07994299
5745,LP6005592-DNA_B04,4,77664,196333,196333,0.39557,132765,63568,2.088550843
5746,LP6005592-DNA_B04,5,60097,164940,164940,0.36436,111496,53444,2.086221091
5747,LP6005592-DNA_B04,6,62280,169317,169317,0.36783,115960,53357,2.173285605
5748,LP6005592-DNA_B04,7,54762,144341,144341,0.37939,98207,46134,2.128733689
5749,LP6005592-DNA_B04,8,50933,143952,143952,0.35382,95450,48502,1.967960084
5750,LP6005592-DNA_B04,9,43056,110892,110892,0.38827,74217,36675,2.023640082
5751,LP6005592-DNA_B04,MT,34,37,37,0.91892,36,1,36
5752,LP6005592-DNA_B04,X,52373,53543,53543,0.97815,35985,17558,2.049493109
5753,LP6005592-DNA_B04,Y,695,715,715,0.97203,420,295,1.423728814
5754,LP6005592-DNA_C01,1,77378,191791,191791,0.40345,132161,59630,2.21635083
5755,LP6005592-DNA_C01,10,51543,124388,124388,0.41437,85478,38910,2.196813159
5756,LP6005592-DNA_C01,11,52740,129151,129151,0.40836,87563,41588,2.10548716
5757,LP6005592-DNA_C01,12,51387,113816,113816,0.45149,78257,35559,2.200764926
5758,LP6005592-DNA_C01,13,44093,101378,101378,0.43494,69117,32261,2.142432039
5759,LP6005592-DNA_C01,14,33693,81248,81248,0.41469,55554,25694,2.162139021
5760,LP6005592-DNA_C01,15,31820,68356,68356,0.4655,46601,21755,2.14208228
5761,LP6005592-DNA_C01,16,28784,68527,68527,0.42004,44901,23626,1.900490985
5762,LP6005592-DNA_C01,17,21467,56596,56596,0.3793,39881,16715,2.385940772
5763,LP6005592-DNA_C01,18,32227,77427,77427,0.41622,53065,24362,2.178187341
5764,LP6005592-DNA_C01,19,15059,40790,40790,0.36918,28808,11982,2.404273076
5765,LP6005592-DNA_C01,2,86494,211801,211801,0.40837,143854,67947,2.117150132
5766,LP6005592-DNA_C01,20,19708,51601,51601,0.38193,36009,15592,2.309453566
5767,LP6005592-DNA_C01,21,14415,35784,35784,0.40283,24358,11426,2.131804656
5768,LP6005592-DNA_C01,22,10158,26910,26910,0.37748,19044,7866,2.421052632
5769,LP6005592-DNA_C01,3,73885,183207,183207,0.40329,123840,59367,2.086007378
5770,LP6005592-DNA_C01,4,81406,190530,190530,0.42726,128871,61659,2.090059845
5771,LP6005592-DNA_C01,5,57778,163205,163205,0.35402,110250,52955,2.081956378
5772,LP6005592-DNA_C01,6,57956,161781,161781,0.35824,110956,50825,2.183098869
5773,LP6005592-DNA_C01,7,55594,134565,134565,0.41314,91562,43003,2.129200288
5774,LP6005592-DNA_C01,8,54013,138560,138560,0.38982,91578,46982,1.949214593
5775,LP6005592-DNA_C01,9,44494,103488,103488,0.42994,69270,34218,2.024373137
5776,LP6005592-DNA_C01,MT,17,18,18,0.94444,NA,NA,NA
5777,LP6005592-DNA_C01,X,31021,69192,69192,0.44833,46627,22565,2.06634168
5778,LP6005592-DNA_C02,1,89040,197547,197547,0.45073,136187,61360,2.219475228
5779,LP6005592-DNA_C02,10,53051,129569,129569,0.40944,89083,40486,2.200340859
5780,LP6005592-DNA_C02,11,57713,126070,126070,0.45779,85422,40648,2.101505609
5781,LP6005592-DNA_C02,12,52322,121339,121339,0.43121,83261,38078,2.186590682
5782,LP6005592-DNA_C02,13,47920,102299,102299,0.46843,69572,32727,2.125828826
5783,LP6005592-DNA_C02,14,32651,85681,85681,0.38108,58800,26881,2.187418623
5784,LP6005592-DNA_C02,15,31252,75090,75090,0.41619,51275,23815,2.153054797
5785,LP6005592-DNA_C02,16,31968,73796,73796,0.43319,48309,25487,1.895436889
5786,LP6005592-DNA_C02,17,23572,57051,57051,0.41317,40271,16780,2.399940405
5787,LP6005592-DNA_C02,18,34621,77757,77757,0.44525,53425,24332,2.195668256
5788,LP6005592-DNA_C02,19,14339,38925,38925,0.36838,27345,11580,2.361398964
5789,LP6005592-DNA_C02,2,94937,213759,213759,0.44413,145218,68541,2.118702674
5790,LP6005592-DNA_C02,20,21863,54469,54469,0.40138,37895,16574,2.286412453
5791,LP6005592-DNA_C02,21,14860,33974,33974,0.43739,23120,10854,2.130090289
5792,LP6005592-DNA_C02,22,11230,27782,27782,0.40422,19526,8256,2.365067829
5793,LP6005592-DNA_C02,3,82106,186688,186688,0.4398,125931,60757,2.072699442
5794,LP6005592-DNA_C02,4,85020,194632,194632,0.43682,131481,63151,2.082009786
5795,LP6005592-DNA_C02,5,63287,158954,158954,0.39815,107100,51854,2.065414433
5796,LP6005592-DNA_C02,6,70494,168797,168797,0.41763,115623,53174,2.174427352
5797,LP6005592-DNA_C02,7,58522,141792,141792,0.41273,96270,45522,2.114801634
5798,LP6005592-DNA_C02,8,56111,142422,142422,0.39398,94239,48183,1.9558558
5799,LP6005592-DNA_C02,9,44936,107276,107276,0.41888,71595,35681,2.006530086
5800,LP6005592-DNA_C02,MT,36,40,40,0.9,38,2,19
5801,LP6005592-DNA_C02,X,50481,51099,51099,0.98791,34326,16773,2.046503309
5802,LP6005592-DNA_C02,Y,981,1006,1006,0.97515,633,373,1.697050938
5803,LP6005592-DNA_C03,1,91165,247078,247078,0.36897,170622,76456,2.231636497
5804,LP6005592-DNA_C03,10,57557,154772,154772,0.37188,106545,48227,2.209239638
5805,LP6005592-DNA_C03,11,59168,154542,154542,0.38286,105167,49375,2.129964557
5806,LP6005592-DNA_C03,12,54093,149271,149271,0.36238,102745,46526,2.208335124
5807,LP6005592-DNA_C03,13,47129,118697,118697,0.39705,80847,37850,2.135984148
5808,LP6005592-DNA_C03,14,39596,104013,104013,0.38068,71220,32793,2.171804958
5809,LP6005592-DNA_C03,15,32951,91651,91651,0.35953,62374,29277,2.13047785
5810,LP6005592-DNA_C03,16,35782,98169,98169,0.36449,64569,33600,1.921696429
5811,LP6005592-DNA_C03,17,30544,81975,81975,0.3726,57867,24108,2.400323544
5812,LP6005592-DNA_C03,18,37181,93742,93742,0.39663,64199,29543,2.173069763
5813,LP6005592-DNA_C03,19,23292,61137,61137,0.38098,43102,18035,2.389908511
5814,LP6005592-DNA_C03,2,98891,270839,270839,0.36513,183969,86870,2.117750662
5815,LP6005592-DNA_C03,20,26165,71956,71956,0.36362,50221,21735,2.310605015
5816,LP6005592-DNA_C03,21,17228,46767,46767,0.36838,31945,14822,2.155242208
5817,LP6005592-DNA_C03,22,14371,38155,38155,0.37665,26978,11177,2.413706719
5818,LP6005592-DNA_C03,3,85142,233797,233797,0.36417,158163,75634,2.091162705
5819,LP6005592-DNA_C03,4,85650,233871,233871,0.36623,158071,75800,2.085369393
5820,LP6005592-DNA_C03,5,73943,210103,210103,0.35194,142124,67979,2.090704482
5821,LP6005592-DNA_C03,6,76418,207383,207383,0.36849,142181,65202,2.180623294
5822,LP6005592-DNA_C03,7,66134,182404,182404,0.36257,123898,58506,2.11769733
5823,LP6005592-DNA_C03,8,64365,185095,185095,0.34774,122941,62154,1.978006243
5824,LP6005592-DNA_C03,9,51657,136808,136808,0.37759,91452,45356,2.016315372
5825,LP6005592-DNA_C03,MT,62,63,63,0.98413,62,1,62
5826,LP6005592-DNA_C03,X,81054,82277,82277,0.98514,55170,27107,2.035267643
5827,LP6005592-DNA_C03,Y,979,1019,1019,0.96075,646,373,1.731903485
5828,LP6005592-DNA_C05,1,97145,249256,249256,0.38974,171906,77350,2.222443439
5829,LP6005592-DNA_C05,10,59686,164639,164639,0.36253,113197,51442,2.200478208
5830,LP6005592-DNA_C05,11,54853,162825,162825,0.33688,110738,52087,2.126019928
5831,LP6005592-DNA_C05,12,54405,150540,150540,0.3614,103254,47286,2.183606141
5832,LP6005592-DNA_C05,13,49228,124147,124147,0.39653,84525,39622,2.133284539
5833,LP6005592-DNA_C05,14,42823,106372,106372,0.40258,72825,33547,2.170834948
5834,LP6005592-DNA_C05,15,37992,91964,91964,0.41312,62509,29455,2.122186386
5835,LP6005592-DNA_C05,16,35143,97623,97623,0.35999,63790,33833,1.885437295
5836,LP6005592-DNA_C05,17,30758,79911,79911,0.3849,56346,23565,2.391088479
5837,LP6005592-DNA_C05,18,37200,98614,98614,0.37723,67712,30902,2.191185037
5838,LP6005592-DNA_C05,19,21049,60022,60022,0.35069,42236,17786,2.374676712
5839,LP6005592-DNA_C05,2,103249,286484,286484,0.3604,194438,92046,2.112400322
5840,LP6005592-DNA_C05,20,26198,73225,73225,0.35777,51073,22152,2.305570603
5841,LP6005592-DNA_C05,21,19307,48971,48971,0.39425,33492,15479,2.163705666
5842,LP6005592-DNA_C05,22,14814,37892,37892,0.39095,26813,11079,2.420164275
5843,LP6005592-DNA_C05,3,97931,244419,244419,0.40067,165484,78935,2.096459112
5844,LP6005592-DNA_C05,4,93608,248876,248876,0.37612,168030,80846,2.078395963
5845,LP6005592-DNA_C05,5,74695,219175,219175,0.3408,148121,71054,2.084625778
5846,LP6005592-DNA_C05,6,80489,210790,210790,0.38184,144717,66073,2.190259259
5847,LP6005592-DNA_C05,7,69241,190245,190245,0.36396,128865,61380,2.099462366
5848,LP6005592-DNA_C05,8,74486,193799,193799,0.38435,128575,65224,1.971283577
5849,LP6005592-DNA_C05,9,57881,140490,140490,0.41199,93944,46546,2.018304473
5850,LP6005592-DNA_C05,MT,88,91,91,0.96703,87,4,21.75
5851,LP6005592-DNA_C05,X,49428,126006,126006,0.39227,84992,41014,2.072268006
5852,LP6005592-DNA_D01,1,82013,195756,195756,0.41896,134975,60781,2.220677514
5853,LP6005592-DNA_D01,10,50994,126271,126271,0.40385,86936,39335,2.210143638
5854,LP6005592-DNA_D01,11,57005,125762,125762,0.45328,85542,40220,2.126852312
5855,LP6005592-DNA_D01,12,50863,116353,116353,0.43714,80043,36310,2.20443404
5856,LP6005592-DNA_D01,13,45455,102845,102845,0.44198,69819,33026,2.114061648
5857,LP6005592-DNA_D01,14,31887,82025,82025,0.38875,56041,25984,2.156750308
5858,LP6005592-DNA_D01,15,31190,71451,71451,0.43652,48618,22833,2.129286559
5859,LP6005592-DNA_D01,16,27821,74012,74012,0.3759,48579,25433,1.910077458
5860,LP6005592-DNA_D01,17,21464,56270,56270,0.38145,39798,16472,2.416100049
5861,LP6005592-DNA_D01,18,32905,76325,76325,0.43112,52276,24049,2.173728637
5862,LP6005592-DNA_D01,19,13431,41332,41332,0.32495,29141,12191,2.390369945
5863,LP6005592-DNA_D01,2,83814,217857,217857,0.38472,147985,69872,2.117944241
5864,LP6005592-DNA_D01,20,19278,51411,51411,0.37498,35740,15671,2.280645779
5865,LP6005592-DNA_D01,21,15845,34056,34056,0.46526,23097,10959,2.107582809
5866,LP6005592-DNA_D01,22,10186,27450,27450,0.37107,19580,7870,2.487928844
5867,LP6005592-DNA_D01,3,74085,184739,184739,0.40103,124640,60099,2.07391138
5868,LP6005592-DNA_D01,4,88052,195589,195589,0.45019,132149,63440,2.083054855
5869,LP6005592-DNA_D01,5,63806,157708,157708,0.40458,106370,51338,2.071954498
5870,LP6005592-DNA_D01,6,63873,165200,165200,0.38664,112958,52242,2.162206654
5871,LP6005592-DNA_D01,7,56198,138321,138321,0.40629,94132,44189,2.130213402
5872,LP6005592-DNA_D01,8,60177,134668,134668,0.44685,89084,45584,1.954282204
5873,LP6005592-DNA_D01,9,46605,101852,101852,0.45758,67895,33957,1.999440469
5874,LP6005592-DNA_D01,MT,30,31,31,0.96774,NA,NA,NA
5875,LP6005592-DNA_D01,X,48119,48809,48809,0.98586,32849,15960,2.05820802
5876,LP6005592-DNA_D01,Y,681,693,693,0.98268,423,270,1.566666667
5877,LP6005592-DNA_D03,1,89373,200021,200021,0.44682,137957,62064,2.222818381
5878,LP6005592-DNA_D03,10,54285,128924,128924,0.42106,88805,40119,2.213539719
5879,LP6005592-DNA_D03,11,57857,128280,128280,0.45102,87113,41167,2.116088129
5880,LP6005592-DNA_D03,12,53274,123597,123597,0.43103,84981,38616,2.200668117
5881,LP6005592-DNA_D03,13,45707,100242,100242,0.45597,68392,31850,2.147315542
5882,LP6005592-DNA_D03,14,35014,85836,85836,0.40792,58579,27257,2.149136002
5883,LP6005592-DNA_D03,15,32352,73597,73597,0.43958,50094,23503,2.131387482
5884,LP6005592-DNA_D03,16,30954,75041,75041,0.41249,49046,25995,1.886747451
5885,LP6005592-DNA_D03,17,26414,61550,61550,0.42915,43303,18247,2.373157231
5886,LP6005592-DNA_D03,18,34526,76570,76570,0.45091,52338,24232,2.159871245
5887,LP6005592-DNA_D03,19,15965,41851,41851,0.38147,29300,12551,2.334475341
5888,LP6005592-DNA_D03,2,96726,217643,217643,0.44443,147725,69918,2.112832175
5889,LP6005592-DNA_D03,20,23066,53964,53964,0.42743,37718,16246,2.321679183
5890,LP6005592-DNA_D03,21,15065,35385,35385,0.42575,24083,11302,2.130861794
5891,LP6005592-DNA_D03,22,12063,28354,28354,0.42544,20005,8349,2.396095341
5892,LP6005592-DNA_D03,3,82437,187355,187355,0.44,126565,60790,2.082003619
5893,LP6005592-DNA_D03,4,86612,191961,191961,0.4512,129586,62375,2.077531062
5894,LP6005592-DNA_D03,5,63250,156321,156321,0.40462,105518,50803,2.077003327
5895,LP6005592-DNA_D03,6,70846,167907,167907,0.42194,115078,52829,2.178311155
5896,LP6005592-DNA_D03,7,60547,142694,142694,0.42431,96991,45703,2.122202044
5897,LP6005592-DNA_D03,8,54895,138528,138528,0.39627,91646,46882,1.954822746
5898,LP6005592-DNA_D03,9,48511,106737,106737,0.45449,71272,35465,2.00964331
5899,LP6005592-DNA_D03,MT,27,31,31,0.87097,27,4,6.75
5900,LP6005592-DNA_D03,X,32240,72052,72052,0.44745,48598,23454,2.072055939
5901,LP6005592-DNA_D04,1,93960,185681,185681,0.50603,128112,57569,2.225364345
5902,LP6005592-DNA_D04,10,51599,128683,128683,0.40098,88586,40097,2.209292466
5903,LP6005592-DNA_D04,11,51400,128363,128363,0.40043,87127,41236,2.112886798
5904,LP6005592-DNA_D04,12,53590,115142,115142,0.46543,79281,35861,2.210786091
5905,LP6005592-DNA_D04,13,45603,101190,101190,0.45067,68911,32279,2.134855479
5906,LP6005592-DNA_D04,14,41076,76800,76800,0.53484,52369,24431,2.143547133
5907,LP6005592-DNA_D04,15,30022,75327,75327,0.39856,51386,23941,2.146359801
5908,LP6005592-DNA_D04,16,33788,74611,74611,0.45286,48839,25772,1.89504113
5909,LP6005592-DNA_D04,17,26352,64439,64439,0.40894,45556,18883,2.41254038
5910,LP6005592-DNA_D04,18,35294,71270,71270,0.49522,48974,22296,2.196537496
5911,LP6005592-DNA_D04,19,16000,45070,45070,0.355,31756,13314,2.38515848
5912,LP6005592-DNA_D04,2,97753,206769,206769,0.47276,140283,66486,2.109963
5913,LP6005592-DNA_D04,20,26386,52147,52147,0.50599,36490,15657,2.330586958
5914,LP6005592-DNA_D04,21,15965,33565,33565,0.47564,22853,10712,2.133401792
5915,LP6005592-DNA_D04,22,11481,29818,29818,0.38504,21095,8723,2.418319386
5916,LP6005592-DNA_D04,3,73010,182978,182978,0.39901,123825,59153,2.093300424
5917,LP6005592-DNA_D04,4,86081,187601,187601,0.45885,127009,60592,2.096134803
5918,LP6005592-DNA_D04,5,61221,161394,161394,0.37933,109142,52252,2.088762153
5919,LP6005592-DNA_D04,6,72576,152710,152710,0.47525,104526,48184,2.169309314
5920,LP6005592-DNA_D04,7,56555,136111,136111,0.41551,92551,43560,2.124678604
5921,LP6005592-DNA_D04,8,54279,138647,138647,0.39149,91856,46791,1.963112564
5922,LP6005592-DNA_D04,9,42629,104975,104975,0.40609,70423,34552,2.038174346
5923,LP6005592-DNA_D04,MT,31,33,33,0.93939,31,2,15.5
5924,LP6005592-DNA_D04,X,49391,50046,50046,0.98691,33596,16450,2.04231003
5925,LP6005592-DNA_D04,Y,670,700,700,0.95714,430,270,1.592592593
5926,LP6005592-DNA_E01,1,79096,182586,182586,0.4332,125625,56961,2.205456365
5927,LP6005592-DNA_E01,10,48435,121656,121656,0.39813,83383,38273,2.178637682
5928,LP6005592-DNA_E01,11,49853,122903,122903,0.40563,83335,39568,2.106121108
5929,LP6005592-DNA_E01,12,46087,119757,119757,0.38484,82205,37552,2.189097784
5930,LP6005592-DNA_E01,13,40939,100954,100954,0.40552,68791,32163,2.138824115
5931,LP6005592-DNA_E01,14,29289,79442,79442,0.36868,54318,25124,2.161996497
5932,LP6005592-DNA_E01,15,27565,70906,70906,0.38875,48244,22662,2.128850057
5933,LP6005592-DNA_E01,16,25897,65702,65702,0.39416,42969,22733,1.89015968
5934,LP6005592-DNA_E01,17,19539,58076,58076,0.33644,40945,17131,2.390111494
5935,LP6005592-DNA_E01,18,28633,75474,75474,0.37938,51667,23807,2.170244046
5936,LP6005592-DNA_E01,19,13688,36021,36021,0.38,25290,10731,2.356723511
5937,LP6005592-DNA_E01,2,82975,208014,208014,0.39889,141106,66908,2.108955581
5938,LP6005592-DNA_E01,20,18157,49679,49679,0.36549,34513,15166,2.275682448
5939,LP6005592-DNA_E01,21,12455,34380,34380,0.36227,23514,10866,2.163997791
5940,LP6005592-DNA_E01,22,8721,23394,23394,0.37279,16529,6865,2.40772032
5941,LP6005592-DNA_E01,3,66855,183943,183943,0.36345,124127,59816,2.075147118
5942,LP6005592-DNA_E01,4,74163,191768,191768,0.38673,129672,62096,2.088250451
5943,LP6005592-DNA_E01,5,57735,158669,158669,0.36387,106762,51907,2.056793881
5944,LP6005592-DNA_E01,6,57723,162471,162471,0.35528,111161,51310,2.16645878
5945,LP6005592-DNA_E01,7,49425,134860,134860,0.36649,91516,43344,2.111387966
5946,LP6005592-DNA_E01,8,52156,138211,138211,0.37737,91599,46612,1.965137733
5947,LP6005592-DNA_E01,9,37431,103778,103778,0.36068,69209,34569,2.002053863
5948,LP6005592-DNA_E01,MT,30,32,32,0.9375,31,1,31
5949,LP6005592-DNA_E01,X,47515,48391,48391,0.9819,32587,15804,2.061946343
5950,LP6005592-DNA_E01,Y,673,689,689,0.97678,422,267,1.580524345
5951,LP6005592-DNA_E02,1,75760,188985,188985,0.40088,130179,58806,2.213702683
5952,LP6005592-DNA_E02,10,47164,124258,124258,0.37957,85281,38977,2.187982656
5953,LP6005592-DNA_E02,11,51792,123019,123019,0.42101,83357,39662,2.101684232
5954,LP6005592-DNA_E02,12,46315,114495,114495,0.40452,78492,36003,2.180151654
5955,LP6005592-DNA_E02,13,43241,100931,100931,0.42842,68556,32375,2.117559846
5956,LP6005592-DNA_E02,14,32204,79290,79290,0.40615,54071,25219,2.144058051
5957,LP6005592-DNA_E02,15,28142,69975,69975,0.40217,47743,22232,2.147490104
5958,LP6005592-DNA_E02,16,26610,71664,71664,0.37132,46759,24905,1.877494479
5959,LP6005592-DNA_E02,17,22494,56870,56870,0.39553,40256,16614,2.423016733
5960,LP6005592-DNA_E02,18,30162,74386,74386,0.40548,50719,23667,2.143026155
5961,LP6005592-DNA_E02,19,14154,38493,38493,0.3677,26997,11496,2.348382046
5962,LP6005592-DNA_E02,2,84712,210563,210563,0.40231,142901,67662,2.111983092
5963,LP6005592-DNA_E02,20,18084,50456,50456,0.35841,35034,15422,2.271689794
5964,LP6005592-DNA_E02,21,13015,34642,34642,0.3757,23601,11041,2.137578118
5965,LP6005592-DNA_E02,22,9598,26385,26385,0.36377,18656,7729,2.413766335
5966,LP6005592-DNA_E02,3,69930,180206,180206,0.38806,121386,58820,2.063685821
5967,LP6005592-DNA_E02,4,79913,193177,193177,0.41368,130200,62977,2.06742144
5968,LP6005592-DNA_E02,5,57271,158413,158413,0.36153,106929,51484,2.076936524
5969,LP6005592-DNA_E02,6,59124,163141,163141,0.36241,111437,51704,2.155287792
5970,LP6005592-DNA_E02,7,51249,132178,132178,0.38773,90022,42156,2.135449284
5971,LP6005592-DNA_E02,8,51652,138716,138716,0.37236,91590,47126,1.943513135
5972,LP6005592-DNA_E02,9,39205,101831,101831,0.385,67792,34039,1.991597873
5973,LP6005592-DNA_E02,MT,11,12,12,0.91667,NA,NA,NA
5974,LP6005592-DNA_E02,X,47520,48130,48130,0.98733,32452,15678,2.069906876
5975,LP6005592-DNA_E02,Y,153,163,163,0.93865,92,71,1.295774648
5976,LP6005592-DNA_F01,1,75930,191074,191074,0.39739,131554,59520,2.210248656
5977,LP6005592-DNA_F01,10,48233,122902,122902,0.39245,84593,38309,2.208175625
5978,LP6005592-DNA_F01,11,53391,124650,124650,0.42833,84204,40446,2.08188696
5979,LP6005592-DNA_F01,12,44825,119239,119239,0.37593,81865,37374,2.1904265
5980,LP6005592-DNA_F01,13,43092,99863,99863,0.43151,68035,31828,2.13758326
5981,LP6005592-DNA_F01,14,29705,81561,81561,0.36421,55739,25822,2.158585702
5982,LP6005592-DNA_F01,15,28524,71560,71560,0.3986,48631,22929,2.120938549
5983,LP6005592-DNA_F01,16,26130,72962,72962,0.35813,47874,25088,1.908242985
5984,LP6005592-DNA_F01,17,22547,58048,58048,0.38842,41052,16996,2.415391857
5985,LP6005592-DNA_F01,18,30584,75280,75280,0.40627,51604,23676,2.179591147
5986,LP6005592-DNA_F01,19,14230,39765,39765,0.35785,28058,11707,2.396685744
5987,LP6005592-DNA_F01,2,83986,210660,210660,0.39868,142972,67688,2.112220778
5988,LP6005592-DNA_F01,20,18414,51060,51060,0.36063,35632,15428,2.309567021
5989,LP6005592-DNA_F01,21,13676,33688,33688,0.40596,22922,10766,2.129110162
5990,LP6005592-DNA_F01,22,8866,26864,26864,0.33003,19066,7798,2.444985894
5991,LP6005592-DNA_F01,3,68555,178514,178514,0.38403,120409,58105,2.072265726
5992,LP6005592-DNA_F01,4,80227,185792,185792,0.43181,125398,60394,2.076332086
5993,LP6005592-DNA_F01,5,64289,155120,155120,0.41445,104805,50315,2.082977243
5994,LP6005592-DNA_F01,6,62293,162384,162384,0.38362,111142,51242,2.16896296
5995,LP6005592-DNA_F01,7,50224,136938,136938,0.36676,93050,43888,2.120169522
5996,LP6005592-DNA_F01,8,50487,136545,136545,0.36975,90403,46142,1.959234537
5997,LP6005592-DNA_F01,9,40532,105576,105576,0.38391,70321,35255,1.994639058
5998,LP6005592-DNA_F01,MT,43,46,46,0.93478,41,5,8.2
5999,LP6005592-DNA_F01,X,27174,70128,70128,0.38749,47101,23027,2.045468363
6000,LP6005592-DNA_F03,1,87573,194970,194970,0.44916,134110,60860,2.203581991
6001,LP6005592-DNA_F03,10,50671,128551,128551,0.39417,88221,40330,2.187478304
6002,LP6005592-DNA_F03,11,54042,128802,128802,0.41957,87266,41536,2.10097265
6003,LP6005592-DNA_F03,12,50570,120983,120983,0.41799,82978,38005,2.183344297
6004,LP6005592-DNA_F03,13,44387,106683,106683,0.41606,72421,34262,2.113741171
6005,LP6005592-DNA_F03,14,32030,85184,85184,0.37601,58198,26986,2.156599718
6006,LP6005592-DNA_F03,15,30450,72519,72519,0.41989,49468,23051,2.146024034
6007,LP6005592-DNA_F03,16,29399,74022,74022,0.39717,48526,25496,1.903278946
6008,LP6005592-DNA_F03,17,24066,57772,57772,0.41657,40707,17065,2.385408731
6009,LP6005592-DNA_F03,18,32032,78868,78868,0.40615,54070,24798,2.180417776
6010,LP6005592-DNA_F03,19,15063,41541,41541,0.36261,29237,12304,2.376219116
6011,LP6005592-DNA_F03,2,92913,212810,212810,0.4366,144329,68481,2.107577284
6012,LP6005592-DNA_F03,20,20758,51292,51292,0.4047,35762,15530,2.302768835
6013,LP6005592-DNA_F03,21,14523,35853,35853,0.40507,24322,11531,2.109270662
6014,LP6005592-DNA_F03,22,10802,27898,27898,0.3872,19665,8233,2.388558241
6015,LP6005592-DNA_F03,3,79719,183380,183380,0.43472,123622,59758,2.068710466
6016,LP6005592-DNA_F03,4,90718,197305,197305,0.45979,132974,64331,2.067028338
6017,LP6005592-DNA_F03,5,64384,157862,157862,0.40785,106474,51388,2.071962326
6018,LP6005592-DNA_F03,6,67529,171679,171679,0.39334,117356,54323,2.160337242
6019,LP6005592-DNA_F03,7,57463,143723,143723,0.39982,97737,45986,2.125364241
6020,LP6005592-DNA_F03,8,54815,142986,142986,0.38336,94572,48414,1.953401909
6021,LP6005592-DNA_F03,9,44479,107245,107245,0.41474,71537,35708,2.003388596
6022,LP6005592-DNA_F03,MT,44,47,47,0.93617,44,3,14.66666667
6023,LP6005592-DNA_F03,X,31453,75540,75540,0.41638,50900,24640,2.065746753
6024,LP6005592-DNA_G01,1,81172,195545,195545,0.41511,134938,60607,2.22644249
6025,LP6005592-DNA_G01,10,48958,131880,131880,0.37123,90544,41336,2.190439326
6026,LP6005592-DNA_G01,11,50284,129401,129401,0.38859,87818,41583,2.11187264
6027,LP6005592-DNA_G01,12,47559,122814,122814,0.38724,84299,38515,2.188731663
6028,LP6005592-DNA_G01,13,44360,102793,102793,0.43155,70176,32617,2.151516081
6029,LP6005592-DNA_G01,14,30973,82261,82261,0.37652,56257,26004,2.163397939
6030,LP6005592-DNA_G01,15,29301,74214,74214,0.39482,50580,23634,2.140137091
6031,LP6005592-DNA_G01,16,28434,74358,74358,0.38239,48633,25725,1.890495627
6032,LP6005592-DNA_G01,17,22599,62912,62912,0.35922,44320,18592,2.383820998
6033,LP6005592-DNA_G01,18,31297,77616,77616,0.40323,53197,24419,2.178508538
6034,LP6005592-DNA_G01,19,15433,43719,43719,0.353,30860,12859,2.399875574
6035,LP6005592-DNA_G01,2,84638,216693,216693,0.39059,146951,69742,2.107066043
6036,LP6005592-DNA_G01,20,19860,54175,54175,0.36659,37752,16423,2.298727395
6037,LP6005592-DNA_G01,21,14703,36661,36661,0.40105,25089,11572,2.16807812
6038,LP6005592-DNA_G01,22,9711,28990,28990,0.33498,20579,8411,2.446676971
6039,LP6005592-DNA_G01,3,70313,186332,186332,0.37735,126048,60284,2.090903059
6040,LP6005592-DNA_G01,4,74528,199022,199022,0.37447,134629,64393,2.090739677
6041,LP6005592-DNA_G01,5,61037,162750,162750,0.37504,109775,52975,2.07220387
6042,LP6005592-DNA_G01,6,58002,167454,167454,0.34638,114838,52616,2.18256804
6043,LP6005592-DNA_G01,7,52250,138855,138855,0.37629,94621,44234,2.139101144
6044,LP6005592-DNA_G01,8,53878,145268,145268,0.37089,96344,48924,1.969258442
6045,LP6005592-DNA_G01,9,38827,108698,108698,0.3572,72738,35960,2.022747497
6046,LP6005592-DNA_G01,MT,34,35,35,0.97143,34,1,34
6047,LP6005592-DNA_G01,X,52236,52875,52875,0.98791,35615,17260,2.063441483
6048,LP6005592-DNA_G01,Y,671,677,677,0.99114,416,261,1.593869732
6049,LP6005592-DNA_G03,1,88126,184791,184791,0.4769,127113,57678,2.203838552
6050,LP6005592-DNA_G03,10,53128,122912,122912,0.43224,84400,38512,2.19152472
6051,LP6005592-DNA_G03,11,48465,125237,125237,0.38699,84829,40408,2.099312017
6052,LP6005592-DNA_G03,12,48673,111914,111914,0.43491,76865,35049,2.193072556
6053,LP6005592-DNA_G03,13,42946,98807,98807,0.43465,67354,31453,2.141417353
6054,LP6005592-DNA_G03,14,31960,82594,82594,0.38695,56327,26267,2.144401721
6055,LP6005592-DNA_G03,15,34218,67158,67158,0.50951,45583,21575,2.112769409
6056,LP6005592-DNA_G03,16,36141,70346,70346,0.51376,45727,24619,1.857386571
6057,LP6005592-DNA_G03,17,25492,63347,63347,0.40242,44697,18650,2.396621984
6058,LP6005592-DNA_G03,18,29311,77947,77947,0.37604,53233,24714,2.153961317
6059,LP6005592-DNA_G03,19,18144,49930,49930,0.36339,35069,14861,2.359800821
6060,LP6005592-DNA_G03,2,81180,213098,213098,0.38095,144347,68751,2.099562188
6061,LP6005592-DNA_G03,20,25229,48369,48369,0.52159,33626,14743,2.280811232
6062,LP6005592-DNA_G03,21,12746,34818,34818,0.36608,23726,11092,2.139019113
6063,LP6005592-DNA_G03,22,9575,28843,28843,0.33197,20308,8535,2.379379028
6064,LP6005592-DNA_G03,3,85306,164823,164823,0.51756,111156,53667,2.071216949
6065,LP6005592-DNA_G03,4,72668,190669,190669,0.38112,128839,61830,2.083761928
6066,LP6005592-DNA_G03,5,65929,147315,147315,0.44754,99301,48014,2.068167618
6067,LP6005592-DNA_G03,6,61354,158344,158344,0.38747,108300,50044,2.164095596
6068,LP6005592-DNA_G03,7,62935,130344,130344,0.48284,88454,41890,2.111577942
6069,LP6005592-DNA_G03,8,54087,138362,138362,0.39091,91581,46781,1.957653748
6070,LP6005592-DNA_G03,9,38521,104729,104729,0.36782,69710,35019,1.990633656
6071,LP6005592-DNA_G03,MT,19,19,19,1,17,2,8.5
6072,LP6005592-DNA_G03,X,48235,50417,50417,0.95672,33699,16718,2.015731547
6073,LP6005592-DNA_G03,Y,560,975,975,0.57436,562,413,1.360774818
6074,LP6005592-DNA_H01,1,82358,196503,196503,0.41912,135685,60818,2.231000691
6075,LP6005592-DNA_H01,10,55983,129101,129101,0.43364,88822,40279,2.205168947
6076,LP6005592-DNA_H01,11,52990,128911,128911,0.41106,87606,41305,2.12095388
6077,LP6005592-DNA_H01,12,46986,120243,120243,0.39076,82667,37576,2.199994677
6078,LP6005592-DNA_H01,13,43816,103616,103616,0.42287,70816,32800,2.15902439
6079,LP6005592-DNA_H01,14,32735,83414,83414,0.39244,57013,26401,2.159501534
6080,LP6005592-DNA_H01,15,29634,78263,78263,0.37865,53268,24995,2.131146229
6081,LP6005592-DNA_H01,16,28882,75704,75704,0.38151,49416,26288,1.879793061
6082,LP6005592-DNA_H01,17,24701,62804,62804,0.3933,44478,18326,2.427043545
6083,LP6005592-DNA_H01,18,32584,76781,76781,0.42438,52754,24027,2.195613268
6084,LP6005592-DNA_H01,19,17632,42861,42861,0.41138,30220,12641,2.390633652
6085,LP6005592-DNA_H01,2,83031,220143,220143,0.37717,149435,70708,2.113410081
6086,LP6005592-DNA_H01,20,19275,54247,54247,0.35532,37965,16282,2.331716005
6087,LP6005592-DNA_H01,21,14347,37202,37202,0.38565,25353,11849,2.139674234
6088,LP6005592-DNA_H01,22,10126,28952,28952,0.34975,20602,8350,2.467305389
6089,LP6005592-DNA_H01,3,71483,188568,188568,0.37908,127671,60897,2.096507217
6090,LP6005592-DNA_H01,4,79217,196974,196974,0.40217,132991,63983,2.078536486
6091,LP6005592-DNA_H01,5,60620,165512,165512,0.36626,111799,53713,2.081414183
6092,LP6005592-DNA_H01,6,64050,169394,169394,0.37811,116039,53355,2.174847718
6093,LP6005592-DNA_H01,7,54901,143523,143523,0.38252,97756,45767,2.135949483
6094,LP6005592-DNA_H01,8,49699,140844,140844,0.35287,93613,47231,1.982024518
6095,LP6005592-DNA_H01,9,43535,104785,104785,0.41547,70291,34494,2.037774685
6096,LP6005592-DNA_H01,MT,15,17,17,0.88235,15,2,7.5
6097,LP6005592-DNA_H01,X,31031,71064,71064,0.43666,48081,22983,2.09202454
6098,LP6005592-DNA_H03,1,82769,186343,186343,0.44418,127604,58739,2.172389724
6099,LP6005592-DNA_H03,10,54266,119940,119940,0.45244,82014,37926,2.162474292
6100,LP6005592-DNA_H03,11,49921,124780,124780,0.40007,84124,40656,2.069165683
6101,LP6005592-DNA_H03,12,47777,117072,117072,0.4081,79893,37179,2.148874365
6102,LP6005592-DNA_H03,13,43948,99878,99878,0.44002,67641,32237,2.098241151
6103,LP6005592-DNA_H03,14,30546,83041,83041,0.36784,56389,26652,2.115751163
6104,LP6005592-DNA_H03,15,29094,71035,71035,0.40957,48118,22917,2.099664005
6105,LP6005592-DNA_H03,16,27763,70536,70536,0.3936,46065,24471,1.882432267
6106,LP6005592-DNA_H03,17,23419,56463,56463,0.41477,39650,16813,2.358294177
6107,LP6005592-DNA_H03,18,30990,72897,72897,0.42512,49647,23250,2.135354839
6108,LP6005592-DNA_H03,19,13064,37897,37897,0.34472,26615,11282,2.359067541
6109,LP6005592-DNA_H03,2,88676,206100,206100,0.43026,138892,67208,2.066599214
6110,LP6005592-DNA_H03,20,21240,50464,50464,0.42089,34920,15544,2.246525991
6111,LP6005592-DNA_H03,21,15046,33635,33635,0.44733,22948,10687,2.147281744
6112,LP6005592-DNA_H03,22,11258,25497,25497,0.44154,18012,7485,2.406412826
6113,LP6005592-DNA_H03,3,76078,180532,180532,0.42141,121341,59191,2.049990708
6114,LP6005592-DNA_H03,4,83410,186016,186016,0.4484,124896,61120,2.043455497
6115,LP6005592-DNA_H03,5,59904,150099,150099,0.3991,100821,49278,2.045963716
6116,LP6005592-DNA_H03,6,78943,149751,149751,0.52716,101976,47775,2.134505495
6117,LP6005592-DNA_H03,7,53247,141054,141054,0.37749,95402,45652,2.089766056
6118,LP6005592-DNA_H03,8,53117,134678,134678,0.3944,88600,46078,1.922826512
6119,LP6005592-DNA_H03,9,39457,108860,108860,0.36246,72151,36709,1.965485303
6120,LP6005592-DNA_H03,MT,30,33,33,0.90909,32,1,32
6121,LP6005592-DNA_H03,X,49687,51989,51989,0.95572,34119,17870,1.909289312
6122,LP6005592-DNA_H03,Y,595,741,741,0.80297,436,305,1.429508197
6123,LP6005619-DNA_B01,1,70468,201064,201064,0.35048,138562,62502,2.216921059
6124,LP6005619-DNA_B01,10,48775,136259,136259,0.35796,93622,42637,2.195792387
6125,LP6005619-DNA_B01,11,50530,129708,129708,0.38957,88023,41685,2.111622886
6126,LP6005619-DNA_B01,12,43411,121423,121423,0.35752,83557,37866,2.206649765
6127,LP6005619-DNA_B01,13,40744,107477,107477,0.3791,73097,34380,2.126148924
6128,LP6005619-DNA_B01,14,30890,85749,85749,0.36024,58555,27194,2.153232331
6129,LP6005619-DNA_B01,15,28276,75165,75165,0.37619,51090,24075,2.12211838
6130,LP6005619-DNA_B01,16,26577,77058,77058,0.3449,50536,26522,1.905436996
6131,LP6005619-DNA_B01,17,20831,57950,57950,0.35947,40926,17024,2.404017857
6132,LP6005619-DNA_B01,18,30455,82700,82700,0.36826,56692,26008,2.179790834
6133,LP6005619-DNA_B01,19,13951,39788,39788,0.35063,27858,11930,2.335121542
6134,LP6005619-DNA_B01,2,88839,219747,219747,0.40428,149378,70369,2.122781338
6135,LP6005619-DNA_B01,20,19546,53954,53954,0.36227,37665,16289,2.312296642
6136,LP6005619-DNA_B01,21,12880,37838,37838,0.3404,25867,11971,2.160805279
6137,LP6005619-DNA_B01,22,8641,27186,27186,0.31785,19210,7976,2.408475426
6138,LP6005619-DNA_B01,3,70589,194259,194259,0.36338,131079,63180,2.074691358
6139,LP6005619-DNA_B01,4,76178,208296,208296,0.36572,140665,67631,2.0798894
6140,LP6005619-DNA_B01,5,59920,179974,179974,0.33294,121477,58497,2.076636409
6141,LP6005619-DNA_B01,6,59886,175147,175147,0.34192,120417,54730,2.200200987
6142,LP6005619-DNA_B01,7,53358,145843,145843,0.36586,99032,46811,2.115571126
6143,LP6005619-DNA_B01,8,66757,138369,138369,0.48246,92083,46286,1.98943525
6144,LP6005619-DNA_B01,9,42334,107903,107903,0.39233,72191,35712,2.021477375
6145,LP6005619-DNA_B01,MT,28,30,30,0.93333,29,1,29
6146,LP6005619-DNA_B01,X,52943,53717,53717,0.98559,35886,17831,2.012562391
6147,LP6005619-DNA_B01,Y,1004,1012,1012,0.99209,627,385,1.628571429
6148,LP6005619-DNA_C01,1,71456,201107,201107,0.35531,138508,62599,2.212623205
6149,LP6005619-DNA_C01,10,45204,132628,132628,0.34083,91201,41427,2.201486953
6150,LP6005619-DNA_C01,11,49963,126667,126667,0.39444,85821,40846,2.10108701
6151,LP6005619-DNA_C01,12,47725,123327,123327,0.38698,84549,38778,2.18033421
6152,LP6005619-DNA_C01,13,42060,108470,108470,0.38776,74020,34450,2.14862119
6153,LP6005619-DNA_C01,14,32065,86911,86911,0.36894,59177,27734,2.133734766
6154,LP6005619-DNA_C01,15,27695,74105,74105,0.37373,50409,23696,2.127321067
6155,LP6005619-DNA_C01,16,24538,72542,72542,0.33826,47618,24924,1.910528005
6156,LP6005619-DNA_C01,17,20581,58093,58093,0.35428,40942,17151,2.387149437
6157,LP6005619-DNA_C01,18,29397,80871,80871,0.3635,55407,25464,2.175895382
6158,LP6005619-DNA_C01,19,13558,39265,39265,0.34529,27636,11629,2.376472612
6159,LP6005619-DNA_C01,2,83788,228170,228170,0.36722,155171,72999,2.125659256
6160,LP6005619-DNA_C01,20,18082,53538,53538,0.33774,37302,16236,2.297487066
6161,LP6005619-DNA_C01,21,13708,37764,37764,0.36299,25923,11841,2.189257664
6162,LP6005619-DNA_C01,22,8739,26077,26077,0.33512,18496,7581,2.43978367
6163,LP6005619-DNA_C01,3,72237,193905,193905,0.37254,131015,62890,2.083240579
6164,LP6005619-DNA_C01,4,74710,205775,205775,0.36307,139129,66646,2.08758215
6165,LP6005619-DNA_C01,5,60284,171062,171062,0.35241,115837,55225,2.097546401
6166,LP6005619-DNA_C01,6,60060,171502,171502,0.3502,117328,54174,2.165762174
6167,LP6005619-DNA_C01,7,51863,149741,149741,0.34635,101580,48161,2.109175474
6168,LP6005619-DNA_C01,8,52774,154193,154193,0.34226,102342,51851,1.973770998
6169,LP6005619-DNA_C01,9,37236,108639,108639,0.34275,72496,36143,2.005810254
6170,LP6005619-DNA_C01,MT,38,40,40,0.95,39,1,39
6171,LP6005619-DNA_C01,X,52545,53243,53243,0.98689,35703,17540,2.035518814
6172,LP6005619-DNA_C01,Y,962,977,977,0.98465,610,367,1.662125341
6173,LP6005677-DNA_A02,1,83284,199379,199379,0.41772,137571,61808,2.225779834
6174,LP6005677-DNA_A02,10,51414,132508,132508,0.38801,91119,41389,2.201526976
6175,LP6005677-DNA_A02,11,51471,126479,126479,0.40695,85774,40705,2.107210416
6176,LP6005677-DNA_A02,12,48459,122653,122653,0.39509,84363,38290,2.20326456
6177,LP6005677-DNA_A02,13,46628,103734,103734,0.4495,70721,33013,2.142216703
6178,LP6005677-DNA_A02,14,33356,83008,83008,0.40184,56769,26239,2.163535196
6179,LP6005677-DNA_A02,15,29935,73839,73839,0.40541,50314,23525,2.138746015
6180,LP6005677-DNA_A02,16,29823,72370,72370,0.41209,47438,24932,1.902695331
6181,LP6005677-DNA_A02,17,22002,58583,58583,0.37557,41316,17267,2.39277234
6182,LP6005677-DNA_A02,18,32690,77993,77993,0.41914,53445,24548,2.177163109
6183,LP6005677-DNA_A02,19,13765,41063,41063,0.33522,28882,12181,2.371069699
6184,LP6005677-DNA_A02,2,85841,220624,220624,0.38908,149792,70832,2.114750395
6185,LP6005677-DNA_A02,20,18067,53289,53289,0.33904,37311,15978,2.335148329
6186,LP6005677-DNA_A02,21,13844,36297,36297,0.38141,24829,11468,2.165068015
6187,LP6005677-DNA_A02,22,10966,28324,28324,0.38716,20083,8241,2.436961534
6188,LP6005677-DNA_A02,3,73481,187035,187035,0.39287,126437,60598,2.086488003
6189,LP6005677-DNA_A02,4,82331,198990,198990,0.41374,134363,64627,2.079053646
6190,LP6005677-DNA_A02,5,58862,161294,161294,0.36494,108925,52369,2.07995188
6191,LP6005677-DNA_A02,6,59656,162830,162830,0.36637,111377,51453,2.164635687
6192,LP6005677-DNA_A02,7,54342,142249,142249,0.38202,96776,45473,2.128207948
6193,LP6005677-DNA_A02,8,55180,142080,142080,0.38837,94011,48069,1.955751108
6194,LP6005677-DNA_A02,9,40590,105734,105734,0.38389,70693,35041,2.017436717
6195,LP6005677-DNA_A02,MT,46,48,48,0.95833,43,5,8.6
6196,LP6005677-DNA_A02,X,32499,72504,72504,0.44824,48984,23520,2.082653061
6197,LP6005677-DNA_A03,1,77154,193563,193563,0.3986,133666,59897,2.231597576
6198,LP6005677-DNA_A03,10,48036,128247,128247,0.37456,88058,40189,2.191097066
6199,LP6005677-DNA_A03,11,52697,127860,127860,0.41215,86772,41088,2.111857477
6200,LP6005677-DNA_A03,12,48033,119262,119262,0.40275,81835,37427,2.186523098
6201,LP6005677-DNA_A03,13,44406,103690,103690,0.42826,70577,33113,2.131398544
6202,LP6005677-DNA_A03,14,32212,82183,82183,0.39195,56469,25714,2.196041067
6203,LP6005677-DNA_A03,15,29343,72816,72816,0.40297,49673,23143,2.146350948
6204,LP6005677-DNA_A03,16,28116,74580,74580,0.37699,49014,25566,1.917155597
6205,LP6005677-DNA_A03,17,22626,58514,58514,0.38668,41347,17167,2.408516339
6206,LP6005677-DNA_A03,18,32350,76816,76816,0.42114,52762,24054,2.193481334
6207,LP6005677-DNA_A03,19,14524,42785,42785,0.33946,30197,12588,2.398871942
6208,LP6005677-DNA_A03,2,95866,202886,202886,0.47251,137558,65328,2.105651482
6209,LP6005677-DNA_A03,20,19115,54499,54499,0.35074,37997,16502,2.302569386
6210,LP6005677-DNA_A03,21,14361,36435,36435,0.39415,24895,11540,2.157279029
6211,LP6005677-DNA_A03,22,10015,28854,28854,0.34709,20444,8410,2.430915577
6212,LP6005677-DNA_A03,3,66422,184834,184834,0.35936,124942,59892,2.086121686
6213,LP6005677-DNA_A03,4,77843,197471,197471,0.3942,133497,63974,2.086738362
6214,LP6005677-DNA_A03,5,57149,163198,163198,0.35018,110207,52991,2.07973052
6215,LP6005677-DNA_A03,6,61322,164105,164105,0.37368,112617,51488,2.187247514
6216,LP6005677-DNA_A03,7,52147,140366,140366,0.37151,95452,44914,2.125217082
6217,LP6005677-DNA_A03,8,52917,137409,137409,0.38511,91061,46348,1.964723397
6218,LP6005677-DNA_A03,9,41116,106921,106921,0.38455,71382,35539,2.008553983
6219,LP6005677-DNA_A03,MT,37,39,39,0.94872,38,1,38
6220,LP6005677-DNA_A03,X,28521,72978,72978,0.39082,49375,23603,2.091895098
6221,LP6005677-DNA_B01,1,78298,190569,190569,0.41086,131102,59467,2.204617687
6222,LP6005677-DNA_B01,10,47709,127881,127881,0.37307,88032,39849,2.209139502
6223,LP6005677-DNA_B01,11,51764,130713,130713,0.39601,88358,42355,2.086129146
6224,LP6005677-DNA_B01,12,49109,116890,116890,0.42013,80425,36465,2.205539558
6225,LP6005677-DNA_B01,13,43900,107001,107001,0.41028,73056,33945,2.152187362
6226,LP6005677-DNA_B01,14,34335,80580,80580,0.4261,54990,25590,2.148886284
6227,LP6005677-DNA_B01,15,28958,72346,72346,0.40027,49212,23134,2.12725858
6228,LP6005677-DNA_B01,16,29204,72244,72244,0.40424,47387,24857,1.906384519
6229,LP6005677-DNA_B01,17,25141,55008,55008,0.45704,38765,16243,2.386566521
6230,LP6005677-DNA_B01,18,32740,76893,76893,0.42579,52767,24126,2.187142502
6231,LP6005677-DNA_B01,19,13656,40439,40439,0.33769,28331,12108,2.339857945
6232,LP6005677-DNA_B01,2,83879,214571,214571,0.39091,146196,68375,2.138149909
6233,LP6005677-DNA_B01,20,19639,52000,52000,0.37767,36397,15603,2.332692431
6234,LP6005677-DNA_B01,21,13242,35808,35808,0.36981,24417,11391,2.143534369
6235,LP6005677-DNA_B01,22,10726,25863,25863,0.41472,18351,7512,2.442891374
6236,LP6005677-DNA_B01,3,71815,181712,181712,0.39521,122825,58887,2.085774449
6237,LP6005677-DNA_B01,4,80239,194815,194815,0.41187,131605,63210,2.08202816
6238,LP6005677-DNA_B01,5,63640,159555,159555,0.39886,107899,51656,2.088798978
6239,LP6005677-DNA_B01,6,61209,162713,162713,0.37618,111327,51386,2.166485035
6240,LP6005677-DNA_B01,7,51211,138627,138627,0.36942,94309,44318,2.128006679
6241,LP6005677-DNA_B01,8,52770,139890,139890,0.37722,92452,47438,1.948901724
6242,LP6005677-DNA_B01,9,39404,108458,108458,0.36331,72243,36215,1.994836394
6243,LP6005677-DNA_B01,MT,13,16,16,0.8125,14,2,7
6244,LP6005677-DNA_B01,X,29715,72073,72073,0.41229,48725,23348,2.086902518
6245,LP6005677-DNA_B02,1,76529,199402,199402,0.38379,137449,61953,2.218601198
6246,LP6005677-DNA_B02,10,52131,129187,129187,0.40353,88581,40606,2.181475644
6247,LP6005677-DNA_B02,11,50819,133920,133920,0.37947,90889,43031,2.112174944
6248,LP6005677-DNA_B02,12,48466,120288,120288,0.40292,82598,37690,2.191509684
6249,LP6005677-DNA_B02,13,44954,102870,102870,0.437,70038,32832,2.133223684
6250,LP6005677-DNA_B02,14,32769,83619,83619,0.39188,57086,26533,2.151509441
6251,LP6005677-DNA_B02,15,30462,75299,75299,0.40455,51252,24047,2.131326153
6252,LP6005677-DNA_B02,16,29669,78179,78179,0.3795,51270,26909,1.905310491
6253,LP6005677-DNA_B02,17,23779,62321,62321,0.38156,43941,18380,2.390696409
6254,LP6005677-DNA_B02,18,33106,77241,77241,0.42861,53036,24205,2.191117538
6255,LP6005677-DNA_B02,19,16238,42243,42243,0.3844,29812,12431,2.398198053
6256,LP6005677-DNA_B02,2,88519,222407,222407,0.398,151302,71105,2.127867239
6257,LP6005677-DNA_B02,20,20386,53792,53792,0.37898,37579,16213,2.31783137
6258,LP6005677-DNA_B02,21,14559,36352,36352,0.4005,24769,11583,2.138392472
6259,LP6005677-DNA_B02,22,10470,31104,31104,0.33661,22081,9023,2.447190513
6260,LP6005677-DNA_B02,3,74155,188620,188620,0.39314,127274,61346,2.074691096
6261,LP6005677-DNA_B02,4,80450,195772,195772,0.41094,132273,63499,2.083072174
6262,LP6005677-DNA_B02,5,60539,157485,157485,0.38441,106092,51393,2.064327827
6263,LP6005677-DNA_B02,6,64409,169265,169265,0.38052,115701,53564,2.160051527
6264,LP6005677-DNA_B02,7,59826,138475,138475,0.43203,94171,44304,2.125564283
6265,LP6005677-DNA_B02,8,54055,139192,139192,0.38835,92064,47128,1.953488372
6266,LP6005677-DNA_B02,9,42521,108362,108362,0.3924,72475,35887,2.019533536
6267,LP6005677-DNA_B02,MT,42,44,44,0.95455,NA,NA,NA
6268,LP6005677-DNA_B02,X,49679,50418,50418,0.98534,33857,16561,2.044381378
6269,LP6005677-DNA_B02,Y,347,363,363,0.95592,216,147,1.469387755
6270,LP6005677-DNA_C03,1,76915,198022,198022,0.38842,136357,61665,2.211254358
6271,LP6005677-DNA_C03,10,51661,130898,130898,0.39467,90085,40813,2.207262392
6272,LP6005677-DNA_C03,11,51795,127370,127370,0.40665,86830,40540,2.141835224
6273,LP6005677-DNA_C03,12,47982,120021,120021,0.39978,82486,37535,2.197575596
6274,LP6005677-DNA_C03,13,43565,105387,105387,0.41338,71944,33443,2.151242412
6275,LP6005677-DNA_C03,14,32703,83068,83068,0.39369,56799,26269,2.162206403
6276,LP6005677-DNA_C03,15,29595,71533,71533,0.41373,48718,22815,2.135349551
6277,LP6005677-DNA_C03,16,26877,73015,73015,0.3681,47954,25061,1.913491082
6278,LP6005677-DNA_C03,17,23122,61982,61982,0.37304,43805,18177,2.409913627
6279,LP6005677-DNA_C03,18,31201,77828,77828,0.4009,53401,24427,2.186146477
6280,LP6005677-DNA_C03,19,14212,43028,43028,0.3303,30316,12712,2.384833228
6281,LP6005677-DNA_C03,2,86372,216945,216945,0.39813,147738,69207,2.134726256
6282,LP6005677-DNA_C03,20,20049,52458,52458,0.38219,36621,15837,2.312369767
6283,LP6005677-DNA_C03,21,14035,34323,34323,0.40891,23373,10950,2.134520548
6284,LP6005677-DNA_C03,22,9692,29208,29208,0.33183,20730,8478,2.445152159
6285,LP6005677-DNA_C03,3,73496,183928,183928,0.39959,124364,59564,2.087905446
6286,LP6005677-DNA_C03,4,76698,198024,198024,0.38732,133924,64100,2.089297972
6287,LP6005677-DNA_C03,5,61454,162815,162815,0.37745,110054,52761,2.08589678
6288,LP6005677-DNA_C03,6,59809,171217,171217,0.34932,117073,54144,2.162252512
6289,LP6005677-DNA_C03,7,53423,145133,145133,0.3681,98762,46371,2.129822518
6290,LP6005677-DNA_C03,8,53036,141301,141301,0.37534,93525,47776,1.95757284
6291,LP6005677-DNA_C03,9,39418,107008,107008,0.36836,71412,35596,2.00618047
6292,LP6005677-DNA_C03,MT,27,27,27,1,NA,NA,NA
6293,LP6005677-DNA_C03,X,51630,52270,52270,0.98776,35080,17190,2.04072135
6294,LP6005677-DNA_C03,Y,141,150,150,0.94,89,61,1.459016393
6295,LP6005677-DNA_D01,1,92804,194063,194063,0.47822,134027,60036,2.232443867
6296,LP6005677-DNA_D01,10,59612,123814,123814,0.48146,85114,38700,2.199328165
6297,LP6005677-DNA_D01,11,61327,122218,122218,0.50178,82937,39281,2.111377002
6298,LP6005677-DNA_D01,12,56115,115108,115108,0.4875,79424,35684,2.225759444
6299,LP6005677-DNA_D01,13,48366,96854,96854,0.49937,66047,30807,2.143895868
6300,LP6005677-DNA_D01,14,36277,79063,79063,0.45884,54211,24852,2.181353613
6301,LP6005677-DNA_D01,15,36660,71516,71516,0.51261,48748,22768,2.141075193
6302,LP6005677-DNA_D01,16,34375,72131,72131,0.47656,47359,24772,1.911795576
6303,LP6005677-DNA_D01,17,26886,59474,59474,0.45206,41941,17533,2.392117721
6304,LP6005677-DNA_D01,18,36454,74422,74422,0.48983,51301,23121,2.218805415
6305,LP6005677-DNA_D01,19,18212,43323,43323,0.42038,30576,12747,2.398682043
6306,LP6005677-DNA_D01,2,103805,205335,205335,0.50554,139510,65825,2.11940752
6307,LP6005677-DNA_D01,20,23088,54119,54119,0.42662,37866,16253,2.32978527
6308,LP6005677-DNA_D01,21,14101,35540,35540,0.39676,24287,11253,2.158268906
6309,LP6005677-DNA_D01,22,13166,29909,29909,0.4402,21206,8703,2.436631047
6310,LP6005677-DNA_D01,3,85058,179238,179238,0.47455,121171,58067,2.086744623
6311,LP6005677-DNA_D01,4,84046,185795,185795,0.45236,125785,60010,2.096067322
6312,LP6005677-DNA_D01,5,64638,153661,153661,0.42065,103874,49787,2.086367927
6313,LP6005677-DNA_D01,6,68494,165921,165921,0.41281,113891,52030,2.188948683
6314,LP6005677-DNA_D01,7,60747,138160,138160,0.43969,94183,43977,2.141642222
6315,LP6005677-DNA_D01,8,57693,137089,137089,0.42084,90741,46348,1.957819108
6316,LP6005677-DNA_D01,9,47488,106677,106677,0.44516,71334,35343,2.018334607
6317,LP6005677-DNA_D01,MT,44,48,48,0.91667,42,6,7
6318,LP6005677-DNA_D01,X,51076,51901,51901,0.9841,34878,17023,2.048875051
6319,LP6005677-DNA_D01,Y,523,554,554,0.94404,342,212,1.613207547
6320,LP6005677-DNA_D03,1,100825,249428,249428,0.40422,172126,77302,2.226669426
6321,LP6005677-DNA_D03,10,60253,164833,164833,0.36554,113288,51545,2.197846542
6322,LP6005677-DNA_D03,11,63998,158364,158364,0.40412,107574,50790,2.118015357
6323,LP6005677-DNA_D03,12,57442,150587,150587,0.38145,103556,47031,2.201866854
6324,LP6005677-DNA_D03,13,48155,124900,124900,0.38555,85201,39699,2.146174967
6325,LP6005677-DNA_D03,14,40920,106464,106464,0.38436,72721,33743,2.155143289
6326,LP6005677-DNA_D03,15,36002,95620,95620,0.37651,65110,30510,2.134054408
6327,LP6005677-DNA_D03,16,48487,85004,85004,0.57041,55898,29106,1.920497492
6328,LP6005677-DNA_D03,17,32667,77582,77582,0.42106,54836,22746,2.410797503
6329,LP6005677-DNA_D03,18,37326,97034,97034,0.38467,66503,30531,2.178212309
6330,LP6005677-DNA_D03,19,22956,61078,61078,0.37585,43177,17901,2.411988157
6331,LP6005677-DNA_D03,2,124063,268873,268873,0.46142,182499,86374,2.112892769
6332,LP6005677-DNA_D03,20,27889,72423,72423,0.38508,50652,21771,2.326581232
6333,LP6005677-DNA_D03,21,20369,47632,47632,0.42763,32551,15081,2.158411246
6334,LP6005677-DNA_D03,22,14055,38409,38409,0.36593,27145,11264,2.409889915
6335,LP6005677-DNA_D03,3,92692,245699,245699,0.37726,165832,79867,2.076351935
6336,LP6005677-DNA_D03,4,130670,212153,212153,0.61592,143140,69013,2.074101981
6337,LP6005677-DNA_D03,5,75079,218169,218169,0.34413,147445,70724,2.084794412
6338,LP6005677-DNA_D03,6,78723,212219,212219,0.37095,145350,66869,2.173652963
6339,LP6005677-DNA_D03,7,71752,187505,187505,0.38267,127402,60103,2.119727801
6340,LP6005677-DNA_D03,8,71464,189913,189913,0.3763,125928,63985,1.96808627
6341,LP6005677-DNA_D03,9,53405,144319,144319,0.37005,96517,47802,2.019099619
6342,LP6005677-DNA_D03,MT,89,92,92,0.96739,87,5,17.4
6343,LP6005677-DNA_D03,X,60420,113466,113466,0.53249,76678,36788,2.084320974
6344,LP6005677-DNA_E01,1,87893,183504,183504,0.47897,126374,57130,2.21204271
6345,LP6005677-DNA_E01,10,55349,119034,119034,0.46498,81854,37180,2.201559978
6346,LP6005677-DNA_E01,11,59422,116968,116968,0.50802,79088,37880,2.087856389
6347,LP6005677-DNA_E01,12,56424,109989,109989,0.513,75693,34296,2.207050385
6348,LP6005677-DNA_E01,13,47818,94792,94792,0.50445,64628,30164,2.142554038
6349,LP6005677-DNA_E01,14,36513,77189,77189,0.47303,52679,24510,2.149286006
6350,LP6005677-DNA_E01,15,32249,70284,70284,0.45884,47910,22374,2.141324752
6351,LP6005677-DNA_E01,16,32361,66368,66368,0.4876,43501,22867,1.902348362
6352,LP6005677-DNA_E01,17,25774,55209,55209,0.46684,38726,16483,2.349450949
6353,LP6005677-DNA_E01,18,34516,70354,70354,0.4906,48081,22273,2.158712342
6354,LP6005677-DNA_E01,19,16803,38378,38378,0.43783,26961,11417,2.361478497
6355,LP6005677-DNA_E01,2,95372,199891,199891,0.47712,135436,64455,2.101248933
6356,LP6005677-DNA_E01,20,22898,46843,46843,0.48882,32592,14251,2.286997404
6357,LP6005677-DNA_E01,21,15741,33143,33143,0.47494,22464,10679,2.10356775
6358,LP6005677-DNA_E01,22,11854,26617,26617,0.44535,18798,7819,2.404143752
6359,LP6005677-DNA_E01,3,80699,176838,176838,0.45634,119007,57831,2.05784095
6360,LP6005677-DNA_E01,4,89287,179720,179720,0.49681,121087,58633,2.065168079
6361,LP6005677-DNA_E01,5,68096,143491,143491,0.47457,96736,46755,2.068997968
6362,LP6005677-DNA_E01,6,76572,152056,152056,0.50358,104020,48036,2.165459239
6363,LP6005677-DNA_E01,7,57607,132998,132998,0.43314,90422,42576,2.123778655
6364,LP6005677-DNA_E01,8,59340,127256,127256,0.4663,84090,43166,1.948060974
6365,LP6005677-DNA_E01,9,47971,98669,98669,0.48618,65651,33018,1.988339694
6366,LP6005677-DNA_E01,MT,32,36,36,0.88889,34,2,17
6367,LP6005677-DNA_E01,X,51481,52504,52504,0.98052,35216,17288,2.037019898
6368,LP6005677-DNA_E01,Y,492,514,514,0.9572,313,201,1.55721393
6369,LP6005677-DNA_F01,1,86437,192591,192591,0.44881,132885,59706,2.225655713
6370,LP6005677-DNA_F01,10,57712,120036,120036,0.48079,82439,37597,2.192701545
6371,LP6005677-DNA_F01,11,58065,121108,121108,0.47945,82079,39029,2.103025955
6372,LP6005677-DNA_F01,12,52110,113639,113639,0.45856,78178,35461,2.204619159
6373,LP6005677-DNA_F01,13,47857,98565,98565,0.48554,67069,31496,2.129445009
6374,LP6005677-DNA_F01,14,33376,81714,81714,0.40845,55791,25923,2.15218146
6375,LP6005677-DNA_F01,15,34134,71005,71005,0.48073,48430,22575,2.145293466
6376,LP6005677-DNA_F01,16,30947,70243,70243,0.44057,46259,23984,1.928744163
6377,LP6005677-DNA_F01,17,26922,57016,57016,0.47218,40185,16831,2.387558671
6378,LP6005677-DNA_F01,18,33715,75224,75224,0.44819,51474,23750,2.167326316
6379,LP6005677-DNA_F01,19,16476,41185,41185,0.40005,29022,12163,2.386088958
6380,LP6005677-DNA_F01,2,106553,201645,201645,0.52842,136817,64828,2.110461529
6381,LP6005677-DNA_F01,20,23482,49278,49278,0.47652,34341,14937,2.299056035
6382,LP6005677-DNA_F01,21,16159,32666,32666,0.49467,22264,10402,2.140357624
6383,LP6005677-DNA_F01,22,11290,25764,25764,0.43821,18276,7488,2.440705128
6384,LP6005677-DNA_F01,3,83578,177822,177822,0.47001,120032,57790,2.07703755
6385,LP6005677-DNA_F01,4,88872,186646,186646,0.47615,126126,60520,2.084038334
6386,LP6005677-DNA_F01,5,62843,155442,155442,0.40429,104658,50784,2.060845936
6387,LP6005677-DNA_F01,6,75485,157098,157098,0.4805,107384,49714,2.160035403
6388,LP6005677-DNA_F01,7,57500,136382,136382,0.42161,92782,43600,2.128027523
6389,LP6005677-DNA_F01,8,65292,126786,126786,0.51498,83894,42892,1.955935839
6390,LP6005677-DNA_F01,9,48875,105387,105387,0.46377,70320,35067,2.005304132
6391,LP6005677-DNA_F01,MT,42,44,44,0.95455,39,5,7.8
6392,LP6005677-DNA_F01,X,33501,68531,68531,0.48884,46285,22246,2.080598759
6393,LP6005677-DNA_G01,1,81041,241604,241604,0.33543,166901,74703,2.234194075
6394,LP6005677-DNA_G01,10,53087,153983,153983,0.34476,106000,47983,2.209115728
6395,LP6005677-DNA_G01,11,50707,152067,152067,0.33345,103855,48212,2.154131751
6396,LP6005677-DNA_G01,12,46049,141456,141456,0.32554,97439,44017,2.213667447
6397,LP6005677-DNA_G01,13,36298,114095,114095,0.31814,77719,36376,2.136546074
6398,LP6005677-DNA_G01,14,34086,100791,100791,0.33818,68888,31903,2.159295364
6399,LP6005677-DNA_G01,15,28342,87554,87554,0.32371,59701,27853,2.143431587
6400,LP6005677-DNA_G01,16,33239,95191,95191,0.34918,62768,32423,1.935909694
6401,LP6005677-DNA_G01,17,26171,79601,79601,0.32878,56170,23431,2.397251504
6402,LP6005677-DNA_G01,18,30272,91710,91710,0.33008,63055,28655,2.200488571
6403,LP6005677-DNA_G01,19,20650,59298,59298,0.34824,41823,17475,2.393304721
6404,LP6005677-DNA_G01,2,87548,265767,265767,0.32942,180657,85110,2.122629538
6405,LP6005677-DNA_G01,20,24000,71878,71878,0.3339,50316,21562,2.333549763
6406,LP6005677-DNA_G01,21,16565,47175,47175,0.35114,32128,15047,2.135176447
6407,LP6005677-DNA_G01,22,12822,41748,41748,0.30713,29670,12078,2.456532538
6408,LP6005677-DNA_G01,3,78378,230059,230059,0.34069,155877,74182,2.101277938
6409,LP6005677-DNA_G01,4,76521,228140,228140,0.33541,154345,73795,2.091537367
6410,LP6005677-DNA_G01,5,66300,201955,201955,0.32829,136622,65333,2.09116373
6411,LP6005677-DNA_G01,6,64984,204520,204520,0.31774,140426,64094,2.190938309
6412,LP6005677-DNA_G01,7,62132,178388,178388,0.3483,121276,57112,2.123476677
6413,LP6005677-DNA_G01,8,57300,180303,180303,0.3178,119762,60541,1.978196594
6414,LP6005677-DNA_G01,9,43491,132227,132227,0.32891,88619,43608,2.032172996
6415,LP6005677-DNA_G01,MT,81,84,84,0.96429,81,3,27
6416,LP6005677-DNA_G01,X,71324,72207,72207,0.98777,48674,23533,2.06832958
6417,LP6005677-DNA_G01,Y,1013,1048,1048,0.9666,653,395,1.653164557
6418,LP6007068-DNA_A01,1,75107,195608,195608,0.38397,134747,60861,2.214012257
6419,LP6007068-DNA_A01,10,51052,129325,129325,0.39476,88857,40468,2.195734902
6420,LP6007068-DNA_A01,11,57451,118757,118757,0.48377,80478,38279,2.102406019
6421,LP6007068-DNA_A01,12,45821,120249,120249,0.38105,82521,37728,2.18726145
6422,LP6007068-DNA_A01,13,44769,102625,102625,0.43624,70084,32541,2.153713776
6423,LP6007068-DNA_A01,14,31155,79986,79986,0.38951,54689,25297,2.161876902
6424,LP6007068-DNA_A01,15,29654,73585,73585,0.40299,50158,23427,2.14103385
6425,LP6007068-DNA_A01,16,28585,72455,72455,0.39452,47574,24881,1.912061412
6426,LP6007068-DNA_A01,17,23342,62519,62519,0.37336,44088,18431,2.392056861
6427,LP6007068-DNA_A01,18,30749,75972,75972,0.40474,52148,23824,2.188885158
6428,LP6007068-DNA_A01,19,14831,45106,45106,0.3288,31534,13572,2.323460065
6429,LP6007068-DNA_A01,2,83655,211537,211537,0.39546,143568,67969,2.112257058
6430,LP6007068-DNA_A01,20,17527,53307,53307,0.32879,37284,16023,2.326905074
6431,LP6007068-DNA_A01,21,16049,35272,35272,0.45501,24051,11221,2.143391855
6432,LP6007068-DNA_A01,22,9790,28715,28715,0.34094,20398,8317,2.452567031
6433,LP6007068-DNA_A01,3,74891,176981,176981,0.42316,119569,57412,2.082648227
6434,LP6007068-DNA_A01,4,75106,192157,192157,0.39086,130012,62145,2.092074986
6435,LP6007068-DNA_A01,5,62735,161240,161240,0.38908,108846,52394,2.077451617
6436,LP6007068-DNA_A01,6,58570,163107,163107,0.35909,111655,51452,2.170080852
6437,LP6007068-DNA_A01,7,49826,139880,139880,0.35621,95139,44741,2.126438837
6438,LP6007068-DNA_A01,8,52666,139670,139670,0.37707,92229,47441,1.944077907
6439,LP6007068-DNA_A01,9,38569,105724,105724,0.36481,70667,35057,2.01577431
6440,LP6007068-DNA_A01,MT,14,16,16,0.875,NA,NA,NA
6441,LP6007068-DNA_A01,X,48544,49212,49212,0.98643,33035,16177,2.042096804
6442,LP6007068-DNA_A01,Y,131,142,142,0.92254,79,63,1.253968254
6443,LP6007069-DNA_A01,1,75016,196666,196666,0.38144,135519,61147,2.216282074
6444,LP6007069-DNA_A01,10,47245,125551,125551,0.3763,86412,39139,2.207823399
6445,LP6007069-DNA_A01,11,53999,126566,126566,0.42665,85636,40930,2.09225507
6446,LP6007069-DNA_A01,12,45539,119391,119391,0.38143,81818,37573,2.177574322
6447,LP6007069-DNA_A01,13,43554,100432,100432,0.43367,68502,31930,2.14538052
6448,LP6007069-DNA_A01,14,30723,82745,82745,0.3713,56433,26312,2.144762846
6449,LP6007069-DNA_A01,15,29959,73415,73415,0.40808,49861,23554,2.11688036
6450,LP6007069-DNA_A01,16,27336,71487,71487,0.38239,46717,24770,1.88603149
6451,LP6007069-DNA_A01,17,21175,59191,59191,0.35774,41684,17507,2.380990461
6452,LP6007069-DNA_A01,18,30744,77817,77817,0.39508,53328,24489,2.177630773
6453,LP6007069-DNA_A01,19,14132,42957,42957,0.32898,30202,12755,2.367855743
6454,LP6007069-DNA_A01,2,83739,212799,212799,0.39351,144391,68408,2.110732663
6455,LP6007069-DNA_A01,20,18716,52543,52543,0.3562,36487,16056,2.272483807
6456,LP6007069-DNA_A01,21,13283,36784,36784,0.36111,25031,11753,2.129754105
6457,LP6007069-DNA_A01,22,9958,27099,27099,0.36747,19159,7940,2.412972292
6458,LP6007069-DNA_A01,3,71367,183448,183448,0.38903,123815,59633,2.076283266
6459,LP6007069-DNA_A01,4,77199,193235,193235,0.39951,130572,62663,2.083717664
6460,LP6007069-DNA_A01,5,59143,162192,162192,0.36465,109367,52825,2.070364411
6461,LP6007069-DNA_A01,6,59115,164283,164283,0.35984,112352,51931,2.163486164
6462,LP6007069-DNA_A01,7,51803,137379,137379,0.37708,93552,43827,2.134574577
6463,LP6007069-DNA_A01,8,51885,141809,141809,0.36588,93718,48091,1.948763802
6464,LP6007069-DNA_A01,9,38695,105334,105334,0.36736,70466,34868,2.020936102
6465,LP6007069-DNA_A01,MT,16,19,19,0.84211,17,2,8.5
6466,LP6007069-DNA_A01,X,29399,72327,72327,0.40647,48782,23545,2.071862391
6467,SS6004467,1,83765,192327,192327,0.43553,132020,60307,2.189132273
6468,SS6004467,10,51543,125599,125599,0.41038,86224,39375,2.189815873
6469,SS6004467,11,55426,122497,122497,0.45247,82836,39661,2.088600893
6470,SS6004467,12,49706,117529,117529,0.42293,80421,37108,2.167214617
6471,SS6004467,13,43835,100214,100214,0.43741,68156,32058,2.126021586
6472,SS6004467,14,32972,81949,81949,0.40235,55909,26040,2.147043011
6473,SS6004467,15,31287,70957,70957,0.44093,48052,22905,2.097882558
6474,SS6004467,16,31198,73120,73120,0.42667,47672,25448,1.87331028
6475,SS6004467,17,25395,58078,58078,0.43726,40768,17310,2.355170422
6476,SS6004467,18,32888,75687,75687,0.43453,51865,23822,2.177189153
6477,SS6004467,19,16842,40916,40916,0.41162,28688,12228,2.346090939
6478,SS6004467,2,92730,207254,207254,0.44742,140454,66800,2.10260479
6479,SS6004467,20,21968,54279,54279,0.40472,37785,16494,2.29083303
6480,SS6004467,21,14398,35203,35203,0.409,24017,11186,2.147058824
6481,SS6004467,22,11203,28502,28502,0.39306,20099,8403,2.391883851
6482,SS6004467,3,75544,180035,180035,0.41961,121361,58674,2.06839486
6483,SS6004467,4,83627,185839,185839,0.45,125148,60691,2.062052034
6484,SS6004467,5,58516,149753,149753,0.39075,101030,48723,2.073558689
6485,SS6004467,6,70342,163154,163154,0.43114,111690,51464,2.170254935
6486,SS6004467,7,56869,139771,139771,0.40687,94890,44881,2.114257704
6487,SS6004467,8,57653,138007,138007,0.41775,91360,46647,1.95853967
6488,SS6004467,9,43466,103982,103982,0.41801,69325,34657,2.000317396
6489,SS6004467,MT,35,38,38,0.92105,35,3,11.66666667
6490,SS6004467,X,50133,51448,51448,0.97444,34247,17201,1.990988896
6491,SS6004467,Y,935,1015,1015,0.92118,639,376,1.699468085
6492,SS6004468,1,79098,196273,196273,0.403,135680,60593,2.239202548
6493,SS6004468,10,51049,127315,127315,0.40097,87828,39487,2.224225695
6494,SS6004468,11,52579,131935,131935,0.39852,89875,42060,2.13682834
6495,SS6004468,12,46567,117528,117528,0.39622,80855,36673,2.204755542
6496,SS6004468,13,42927,102092,102092,0.42047,69668,32424,2.148655317
6497,SS6004468,14,31461,81371,81371,0.38664,55537,25834,2.149763877
6498,SS6004468,15,30741,74637,74637,0.41187,50872,23765,2.140626972
6499,SS6004468,16,28173,72974,72974,0.38607,47953,25021,1.916510131
6500,SS6004468,17,24506,62553,62553,0.39176,44214,18339,2.410927531
6501,SS6004468,18,30892,75740,75740,0.40787,52101,23639,2.204027243
6502,SS6004468,19,15787,44790,44790,0.35247,31715,13075,2.425621415
6503,SS6004468,2,85136,215632,215632,0.39482,146743,68889,2.130136887
6504,SS6004468,20,19519,54518,54518,0.35803,38005,16513,2.301520015
6505,SS6004468,21,14576,35244,35244,0.41357,24178,11066,2.184890656
6506,SS6004468,22,10342,29738,29738,0.34777,21207,8531,2.485875044
6507,SS6004468,3,71229,184349,184349,0.38638,124616,59733,2.086216999
6508,SS6004468,4,77556,189082,189082,0.41017,128260,60822,2.10877643
6509,SS6004468,5,59643,163399,163399,0.36501,110630,52769,2.096496049
6510,SS6004468,6,57590,165584,165584,0.3478,113686,51898,2.19056611
6511,SS6004468,7,51025,137326,137326,0.37156,93693,43633,2.147296771
6512,SS6004468,8,52289,137567,137567,0.3801,91243,46324,1.969670149
6513,SS6004468,9,40880,105950,105950,0.38584,71074,34876,2.037905723
6514,SS6004468,MT,31,34,34,0.91176,30,4,7.5
6515,SS6004468,X,49087,50125,50125,0.97929,33682,16443,2.048409658
6516,SS6004468,Y,128,153,153,0.8366,82,71,1.154929577
6517,SS6004469,1,84611,192023,192023,0.44063,131590,60433,2.177452716
6518,SS6004469,10,54462,127681,127681,0.42655,87422,40259,2.171489605
6519,SS6004469,11,54450,121048,121048,0.44982,81900,39148,2.092060897
6520,SS6004469,12,51633,118107,118107,0.43717,80859,37248,2.170827964
6521,SS6004469,13,49241,98543,98543,0.49969,66714,31829,2.09601307
6522,SS6004469,14,34135,82225,82225,0.41514,55861,26364,2.118836292
6523,SS6004469,15,31223,71357,71357,0.43756,48446,22911,2.114530138
6524,SS6004469,16,30047,72051,72051,0.41702,46867,25184,1.860983164
6525,SS6004469,17,24521,57341,57341,0.42763,40068,17273,2.319689689
6526,SS6004469,18,32061,75997,75997,0.42187,51870,24127,2.149873586
6527,SS6004469,19,16829,42415,42415,0.39677,29519,12896,2.289004342
6528,SS6004469,2,90922,214122,214122,0.42463,144633,69489,2.081379787
6529,SS6004469,20,21845,53938,53938,0.405,37549,16389,2.291109891
6530,SS6004469,21,14238,35640,35640,0.39949,24195,11445,2.114023591
6531,SS6004469,22,10986,27942,27942,0.39317,19646,8296,2.368129219
6532,SS6004469,3,79751,182100,182100,0.43795,122429,59671,2.051733673
6533,SS6004469,4,82755,189816,189816,0.43597,127929,61887,2.067138494
6534,SS6004469,5,61260,156994,156994,0.39021,105541,51453,2.051211786
6535,SS6004469,6,69933,164248,164248,0.42578,111703,52545,2.12585403
6536,SS6004469,7,58199,138590,138590,0.41994,93746,44844,2.090491482
6537,SS6004469,8,56007,137256,137256,0.40805,90663,46593,1.945850235
6538,SS6004469,9,45191,105188,105188,0.42962,69920,35268,1.982533742
6539,SS6004469,MT,26,29,29,0.89655,27,2,13.5
6540,SS6004469,X,51043,52429,52429,0.97356,34905,17524,1.991839763
6541,SS6004469,Y,627,728,728,0.86126,431,297,1.451178451
6542,SS6004470,1,76915,227225,227225,0.3385,156522,70703,2.213795737
6543,SS6004470,10,49049,148330,148330,0.33067,101993,46337,2.201113581
6544,SS6004470,11,49134,148793,148793,0.33022,101136,47657,2.122164635
6545,SS6004470,12,44845,137503,137503,0.32614,94485,43018,2.196406156
6546,SS6004470,13,36695,111499,111499,0.32911,76065,35434,2.146667043
6547,SS6004470,14,33626,97817,97817,0.34376,66828,30989,2.156507148
6548,SS6004470,15,29388,88502,88502,0.33206,60214,28288,2.128605769
6549,SS6004470,16,30849,92679,92679,0.33286,60651,32028,1.893686774
6550,SS6004470,17,24710,74644,74644,0.33104,52475,22169,2.367044071
6551,SS6004470,18,29027,88399,88399,0.32836,60434,27965,2.161058466
6552,SS6004470,19,19166,56956,56956,0.33651,39870,17086,2.333489407
6553,SS6004470,2,85102,258276,258276,0.3295,175445,82831,2.118107955
6554,SS6004470,20,22559,67742,67742,0.33301,47237,20505,2.303682029
6555,SS6004470,21,15508,45023,45023,0.34445,30712,14311,2.146041507
6556,SS6004470,22,12896,37671,37671,0.34233,26706,10965,2.435567715
6557,SS6004470,3,76710,221758,221758,0.34592,149715,72043,2.078133892
6558,SS6004470,4,77150,221444,221444,0.3484,149732,71712,2.087962963
6559,SS6004470,5,63860,194581,194581,0.32819,131580,63001,2.088538277
6560,SS6004470,6,66223,195628,195628,0.33851,134108,61520,2.179908973
6561,SS6004470,7,58571,172784,172784,0.33898,117050,55734,2.100154304
6562,SS6004470,8,58986,174021,174021,0.33896,115583,58438,1.977873986
6563,SS6004470,9,42789,129372,129372,0.33074,86343,43029,2.00662344
6564,SS6004470,MT,79,83,83,0.95181,80,3,26.66666667
6565,SS6004470,X,71057,72453,72453,0.98073,48573,23880,2.034045226
6566,SS6004470,Y,1001,1081,1081,0.92599,679,402,1.689054726
6567,SS6004471,1,88720,245165,245165,0.36188,169235,75930,2.228829185
6568,SS6004471,10,58183,160714,160714,0.36203,110392,50322,2.193712492
6569,SS6004471,11,58003,157086,157086,0.36924,106711,50375,2.118332506
6570,SS6004471,12,54039,150989,150989,0.3579,103479,47510,2.178046727
6571,SS6004471,13,44164,121659,121659,0.36301,82854,38805,2.135137225
6572,SS6004471,14,42349,103462,103462,0.40932,70780,32682,2.165718132
6573,SS6004471,15,32778,95316,95316,0.34389,64905,30411,2.134260629
6574,SS6004471,16,36631,101922,101922,0.3594,66736,35186,1.896663446
6575,SS6004471,17,29913,81026,81026,0.36918,56919,24107,2.361098436
6576,SS6004471,18,34349,94324,94324,0.36416,64475,29849,2.160038862
6577,SS6004471,19,22046,62562,62562,0.35239,43875,18687,2.347888907
6578,SS6004471,2,101047,276667,276667,0.36523,187637,89030,2.107570482
6579,SS6004471,20,26224,74451,74451,0.35223,51924,22527,2.304967372
6580,SS6004471,21,16284,47922,47922,0.3398,32713,15209,2.150897495
6581,SS6004471,22,14876,40589,40589,0.3665,28666,11923,2.404260673
6582,SS6004471,3,90835,235321,235321,0.386,158849,76472,2.077217805
6583,SS6004471,4,88546,240078,240078,0.36882,162098,77980,2.07871249
6584,SS6004471,5,73924,213808,213808,0.34575,144427,69381,2.081650596
6585,SS6004471,6,80710,206827,206827,0.39023,141573,65254,2.169568149
6586,SS6004471,7,64048,186504,186504,0.34341,126519,59985,2.109177294
6587,SS6004471,8,66612,188105,188105,0.35412,124800,63305,1.971408262
6588,SS6004471,9,26039,73619,73619,0.3537,48294,25325,1.906969398
6589,SS6004471,MT,84,89,89,0.94382,85,4,21.25
6590,SS6004471,X,77349,78696,78696,0.98288,52725,25971,2.030149012
6591,SS6004471,Y,962,1030,1030,0.93398,648,382,1.696335079
6592,SS6004472,1,102540,187123,187123,0.54798,128817,58306,2.209326656
6593,SS6004472,10,61647,123858,123858,0.49772,84944,38914,2.182864779
6594,SS6004472,11,62916,119671,119671,0.52574,80906,38765,2.087088869
6595,SS6004472,12,60767,116674,116674,0.52083,80376,36298,2.214336878
6596,SS6004472,13,49817,96631,96631,0.51554,65455,31176,2.099531691
6597,SS6004472,14,37963,77979,77979,0.48684,53133,24846,2.138493118
6598,SS6004472,15,36486,74177,74177,0.49188,50307,23870,2.107540846
6599,SS6004472,16,37114,72997,72997,0.50843,47922,25075,1.91114656
6600,SS6004472,17,30531,62192,62192,0.49092,43729,18463,2.368466663
6601,SS6004472,18,36850,76062,76062,0.48447,52135,23927,2.178919213
6602,SS6004472,19,21331,46059,46059,0.46312,32423,13636,2.377750073
6603,SS6004472,2,109370,200775,200775,0.54474,136100,64675,2.104367994
6604,SS6004472,20,25254,54832,54832,0.46057,38127,16705,2.282370548
6605,SS6004472,21,18082,36172,36172,0.49989,24655,11517,2.140748459
6606,SS6004472,22,14654,28786,28786,0.50907,20399,8387,2.432216526
6607,SS6004472,3,91640,186214,186214,0.49212,125738,60476,2.079138832
6608,SS6004472,4,93709,183709,183709,0.51009,124262,59447,2.090298922
6609,SS6004472,5,73633,153187,153187,0.48067,103478,49709,2.081675351
6610,SS6004472,6,79687,163199,163199,0.48828,111347,51852,2.147400293
6611,SS6004472,7,70053,136745,136745,0.51229,92814,43931,2.112722223
6612,SS6004472,8,73088,135697,135697,0.53861,89659,46038,1.947499891
6613,SS6004472,9,52052,103410,103410,0.50336,68856,34554,1.992707067
6614,SS6004472,MT,28,34,34,0.82353,32,2,16
6615,SS6004472,X,52841,53862,53862,0.98104,36040,17822,2.022219728
6616,SS6004472,Y,926,954,954,0.97065,601,353,1.702549575
6617,SS6004473,1,91793,247546,247546,0.37081,170711,76835,2.221786946
6618,SS6004473,10,58364,164055,164055,0.35576,112743,51312,2.197205332
6619,SS6004473,11,58309,161335,161335,0.36142,109741,51594,2.127010893
6620,SS6004473,12,58926,144021,144021,0.40915,99036,44985,2.201533845
6621,SS6004473,13,42845,122836,122836,0.3488,83628,39208,2.132932055
6622,SS6004473,14,46884,98531,98531,0.47583,67335,31196,2.158449801
6623,SS6004473,15,36654,96058,96058,0.38158,65115,30943,2.104353165
6624,SS6004473,16,35672,99423,99423,0.35879,65190,34233,1.904302866
6625,SS6004473,17,29941,81642,81642,0.36674,57470,24172,2.377544266
6626,SS6004473,18,34044,95773,95773,0.35547,65677,30096,2.182250133
6627,SS6004473,19,23755,62359,62359,0.38094,43933,18426,2.384293932
6628,SS6004473,2,104601,279749,279749,0.37391,189389,90360,2.095938468
6629,SS6004473,20,28796,73025,73025,0.39433,51003,22022,2.31600218
6630,SS6004473,21,18608,48647,48647,0.38251,33154,15493,2.139934164
6631,SS6004473,22,15331,40839,40839,0.3754,28816,12023,2.396739582
6632,SS6004473,3,86069,241429,241429,0.3565,162985,78444,2.077724236
6633,SS6004473,4,88527,243244,243244,0.36394,164459,78785,2.087440503
6634,SS6004473,5,80150,216047,216047,0.37098,146261,69786,2.095850171
6635,SS6004473,6,74230,206736,206736,0.35906,141247,65489,2.15680496
6636,SS6004473,7,71316,184621,184621,0.38628,125203,59418,2.107156081
6637,SS6004473,8,66083,189189,189189,0.3493,125169,64020,1.955154639
6638,SS6004473,9,57014,138811,138811,0.41073,92771,46040,2.015008688
6639,SS6004473,MT,87,89,89,0.97753,85,4,21.25
6640,SS6004473,X,83545,85006,85006,0.98281,57180,27826,2.054912672
6641,SS6004473,Y,1748,1861,1861,0.93928,1193,668,1.785928144
6642,SS6004474,1,81423,195355,195355,0.4168,134996,60359,2.236551301
6643,SS6004474,10,52195,127298,127298,0.41002,87695,39603,2.214352448
6644,SS6004474,11,53358,126862,126862,0.4206,86405,40457,2.135724349
6645,SS6004474,12,48098,118703,118703,0.4052,81565,37138,2.196267974
6646,SS6004474,13,47254,94495,94495,0.50007,64722,29773,2.173848789
6647,SS6004474,14,33258,82406,82406,0.40359,56425,25981,2.171779377
6648,SS6004474,15,30248,73877,73877,0.40944,50387,23490,2.145040443
6649,SS6004474,16,31042,75351,75351,0.41197,49603,25748,1.926479727
6650,SS6004474,17,23842,64535,64535,0.36944,45604,18931,2.408958851
6651,SS6004474,18,32802,73705,73705,0.44504,50592,23113,2.188898023
6652,SS6004474,19,16506,44966,44966,0.36708,31804,13162,2.416350099
6653,SS6004474,2,84010,215124,215124,0.39052,146441,68683,2.132128765
6654,SS6004474,20,19908,56312,56312,0.35353,39430,16882,2.335623741
6655,SS6004474,21,13973,34890,34890,0.40049,23947,10943,2.188339578
6656,SS6004474,22,10614,31672,31672,0.33512,22587,9085,2.486186021
6657,SS6004474,3,71719,181519,181519,0.3951,122911,58608,2.097171035
6658,SS6004474,4,76627,178863,178863,0.42841,121081,57782,2.095479561
6659,SS6004474,5,58918,158132,158132,0.37259,107179,50953,2.103487528
6660,SS6004474,6,62687,158315,158315,0.39596,108646,49669,2.187400592
6661,SS6004474,7,52329,138848,138848,0.37688,94881,43967,2.158004867
6662,SS6004474,8,52858,138229,138229,0.38239,91837,46392,1.979586998
6663,SS6004474,9,41264,104463,104463,0.39501,70057,34406,2.036185549
6664,SS6004474,MT,31,36,36,0.86111,34,2,17
6665,SS6004474,X,47840,48667,48667,0.98301,32721,15946,2.051987959
6666,SS6004474,Y,709,771,771,0.91958,467,304,1.536184211
6667,SS6004475,1,76310,235168,235168,0.32449,162137,73031,2.220112007
6668,SS6004475,10,49883,152762,152762,0.32654,105350,47412,2.222011305
6669,SS6004475,11,50398,146030,146030,0.34512,99510,46520,2.139079966
6670,SS6004475,12,46738,140134,140134,0.33352,96580,43554,2.217477155
6671,SS6004475,13,36374,109134,109134,0.3333,74700,34434,2.169367486
6672,SS6004475,14,33202,99713,99713,0.33298,68408,31305,2.18521003
6673,SS6004475,15,30278,89812,89812,0.33713,60932,28880,2.109833795
6674,SS6004475,16,31269,95438,95438,0.32764,62778,32660,1.922167789
6675,SS6004475,17,26760,77592,77592,0.34488,54882,22710,2.41664465
6676,SS6004475,18,29953,87922,87922,0.34068,60289,27633,2.181775413
6677,SS6004475,19,19999,58688,58688,0.34077,41246,17442,2.364751749
6678,SS6004475,2,86357,254976,254976,0.33869,173681,81295,2.136429055
6679,SS6004475,20,22793,70495,70495,0.32333,49294,21201,2.325079006
6680,SS6004475,21,16245,43798,43798,0.37091,29977,13821,2.168945807
6681,SS6004475,22,14206,40056,40056,0.35465,28352,11704,2.422419686
6682,SS6004475,3,72834,221501,221501,0.32882,150086,71415,2.101603305
6683,SS6004475,4,72177,215979,215979,0.33419,146207,69772,2.095496761
6684,SS6004475,5,64241,194044,194044,0.33106,131495,62549,2.102271819
6685,SS6004475,6,64209,194212,194212,0.33061,133411,60801,2.194223779
6686,SS6004475,7,59404,173747,173747,0.3419,118253,55494,2.130915054
6687,SS6004475,8,57375,171973,171973,0.33363,114359,57614,1.98491686
6688,SS6004475,9,44759,128668,128668,0.34786,86032,42636,2.017825312
6689,SS6004475,MT,56,59,59,0.94915,58,1,58
6690,SS6004475,X,72171,73388,73388,0.98342,49222,24166,2.036828602
6691,SS6004475,Y,968,1040,1040,0.93077,659,381,1.729658793
6692,SS6004476,1,99152,182038,182038,0.54468,125096,56942,2.196902111
6693,SS6004476,10,58825,119493,119493,0.49229,81950,37543,2.182830355
6694,SS6004476,11,60478,117078,117078,0.51656,79150,37928,2.086848766
6695,SS6004476,12,58532,109139,109139,0.53631,74684,34455,2.167580903
6696,SS6004476,13,52278,95333,95333,0.54837,64894,30439,2.131936003
6697,SS6004476,14,38664,75482,75482,0.51223,51291,24191,2.120251333
6698,SS6004476,15,33970,68834,68834,0.49351,46741,22093,2.11564749
6699,SS6004476,16,36279,66494,66494,0.5456,43279,23215,1.864268792
6700,SS6004476,17,28098,54227,54227,0.51816,38064,16163,2.355008352
6701,SS6004476,18,36739,70688,70688,0.51973,48517,22171,2.188309052
6702,SS6004476,19,20115,39684,39684,0.50688,27882,11802,2.362480935
6703,SS6004476,2,104675,197253,197253,0.53066,133463,63790,2.092224487
6704,SS6004476,20,24516,50340,50340,0.48701,35090,15250,2.300983607
6705,SS6004476,21,16355,34507,34507,0.47396,23558,10949,2.151612019
6706,SS6004476,22,13271,26026,26026,0.50991,18360,7666,2.394990869
6707,SS6004476,3,93188,166692,166692,0.55904,112215,54477,2.059860124
6708,SS6004476,4,94190,179936,179936,0.52346,121311,58625,2.069270789
6709,SS6004476,5,72070,144516,144516,0.4987,97255,47261,2.057827807
6710,SS6004476,6,79497,154732,154732,0.51377,105414,49318,2.137434608
6711,SS6004476,7,64336,131307,131307,0.48997,89387,41920,2.132323473
6712,SS6004476,8,70047,125526,125526,0.55803,82787,42739,1.93703643
6713,SS6004476,9,53127,97423,97423,0.54532,64881,32542,1.993761908
6714,SS6004476,MT,35,37,37,0.94595,35,2,17.5
6715,SS6004476,X,49511,50347,50347,0.9834,33789,16558,2.040645005
6716,SS6004476,Y,485,514,514,0.94358,313,201,1.55721393
6717,SS6004477,1,95249,195088,195088,0.48824,133998,61090,2.193452284
6718,SS6004477,10,61270,126981,126981,0.48251,87152,39829,2.18815436
6719,SS6004477,11,61231,124118,124118,0.49333,84209,39909,2.110025308
6720,SS6004477,12,57034,120929,120929,0.47163,83099,37830,2.196642876
6721,SS6004477,13,50043,98955,98955,0.50571,67443,31512,2.140232292
6722,SS6004477,14,37028,81043,81043,0.45689,55440,25603,2.165371246
6723,SS6004477,15,33958,75217,75217,0.45147,50991,24226,2.104804755
6724,SS6004477,16,34926,77031,77031,0.4534,50230,26801,1.874183799
6725,SS6004477,17,26877,61009,61009,0.44054,42817,18192,2.353616974
6726,SS6004477,18,39079,77751,77751,0.50262,53107,24644,2.154966726
6727,SS6004477,19,20376,47970,47970,0.42477,33537,14433,2.32363334
6728,SS6004477,2,102039,209690,209690,0.48662,141975,67715,2.096655099
6729,SS6004477,20,24112,55089,55089,0.43769,38343,16746,2.289681118
6730,SS6004477,21,16221,36423,36423,0.44535,24752,11671,2.12081227
6731,SS6004477,22,14386,27240,27240,0.52812,19211,8029,2.392701457
6732,SS6004477,3,87920,195341,195341,0.45008,132114,63227,2.089518718
6733,SS6004477,4,91927,186423,186423,0.49311,126032,60391,2.086933483
6734,SS6004477,5,69080,156217,156217,0.44221,105283,50934,2.067047552
6735,SS6004477,6,78553,168021,168021,0.46752,114884,53137,2.162033988
6736,SS6004477,7,62592,143250,143250,0.43694,97172,46078,2.108858891
6737,SS6004477,8,66934,139585,139585,0.47952,92454,47131,1.961638836
6738,SS6004477,9,49485,107811,107811,0.459,71703,36108,1.985792622
6739,SS6004477,MT,31,35,35,0.88571,32,3,10.66666667
6740,SS6004477,X,53692,54486,54486,0.98543,36681,17805,2.060151643
6741,SS6004477,Y,962,1013,1013,0.94965,647,366,1.767759563
6742,SS6004478,1,91255,198804,198804,0.45902,136917,61887,2.212370934
6743,SS6004478,10,57268,128621,128621,0.44525,88483,40138,2.20446958
6744,SS6004478,11,60527,121469,121469,0.49829,82470,38999,2.114669607
6745,SS6004478,12,58487,119767,119767,0.48834,82377,37390,2.203182669
6746,SS6004478,13,47813,99316,99316,0.48142,67532,31784,2.124716839
6747,SS6004478,14,36607,82090,82090,0.44594,56116,25974,2.16046816
6748,SS6004478,15,34563,74328,74328,0.46501,50476,23852,2.116216669
6749,SS6004478,16,34431,76865,76865,0.44794,50237,26628,1.886623104
6750,SS6004478,17,28377,61289,61289,0.463,43152,18137,2.379224789
6751,SS6004478,18,36597,75416,75416,0.48527,51587,23829,2.164883126
6752,SS6004478,19,19557,45628,45628,0.42862,32052,13576,2.360931055
6753,SS6004478,2,103776,207853,207853,0.49928,140633,67220,2.092130318
6754,SS6004478,20,24561,55230,55230,0.4447,38465,16765,2.294363257
6755,SS6004478,21,17086,37110,37110,0.46041,25300,11810,2.142252329
6756,SS6004478,22,14520,29151,29151,0.4981,20556,8595,2.391623037
6757,SS6004478,3,87482,191494,191494,0.45684,129140,62354,2.071078038
6758,SS6004478,4,90273,184129,184129,0.49027,124365,59764,2.080935011
6759,SS6004478,5,68530,159539,159539,0.42955,107764,51775,2.081390633
6760,SS6004478,6,77134,165773,165773,0.4653,113296,52477,2.15896488
6761,SS6004478,7,61803,138607,138607,0.44589,94093,44514,2.113784427
6762,SS6004478,8,64347,140147,140147,0.45914,92806,47341,1.960372616
6763,SS6004478,9,52335,109375,109375,0.47849,73146,36229,2.018990312
6764,SS6004478,MT,47,52,52,0.90385,49,3,16.33333333
6765,SS6004478,X,36303,74137,74137,0.48967,49747,24390,2.039647396
6766,SS6004479,1,91911,188446,188446,0.48773,129946,58500,2.221299145
6767,SS6004479,10,56276,121610,121610,0.46276,83665,37945,2.204901832
6768,SS6004479,11,57252,120520,120520,0.47504,81934,38586,2.123412637
6769,SS6004479,12,54435,113308,113308,0.48042,77941,35367,2.203777533
6770,SS6004479,13,47539,95589,95589,0.49733,65304,30285,2.156315007
6771,SS6004479,14,40395,78465,78465,0.51482,53398,25067,2.130211034
6772,SS6004479,15,33070,67991,67991,0.48639,46329,21662,2.138722186
6773,SS6004479,16,35390,71897,71897,0.49223,47068,24829,1.895686496
6774,SS6004479,17,28546,56528,56528,0.50499,39670,16858,2.353185431
6775,SS6004479,18,35365,71154,71154,0.49702,48785,22369,2.180920023
6776,SS6004479,19,18487,39814,39814,0.46433,27957,11857,2.357847685
6777,SS6004479,2,100689,197802,197802,0.50904,133861,63941,2.093508078
6778,SS6004479,20,24140,48854,48854,0.49413,34107,14747,2.312809385
6779,SS6004479,21,15306,33018,33018,0.46357,22598,10420,2.168714012
6780,SS6004479,22,13123,27246,27246,0.48165,19279,7967,2.41985691
6781,SS6004479,3,80780,174645,174645,0.46254,117847,56798,2.074844185
6782,SS6004479,4,92922,172757,172757,0.53788,116766,55991,2.085442303
6783,SS6004479,5,68473,145280,145280,0.47132,98189,47091,2.085090569
6784,SS6004479,6,72557,155325,155325,0.46713,106230,49095,2.163764131
6785,SS6004479,7,59915,133858,133858,0.4476,90970,42888,2.121106137
6786,SS6004479,8,58731,129284,129284,0.45428,85492,43792,1.952228718
6787,SS6004479,9,46998,101740,101740,0.46194,67873,33867,2.00410429
6788,SS6004479,MT,43,46,46,0.93478,41,5,8.2
6789,SS6004479,X,36004,66726,66726,0.53958,44929,21797,2.061246961
6790,SS6004480,1,82277,214671,214671,0.38327,147798,66873,2.210129649
6791,SS6004480,10,48158,141292,141292,0.34084,97174,44118,2.202593046
6792,SS6004480,11,49582,140644,140644,0.35254,95677,44967,2.127715881
6793,SS6004480,12,45511,127884,127884,0.35588,87834,40050,2.193108614
6794,SS6004480,13,38437,107968,107968,0.356,73443,34525,2.12724113
6795,SS6004480,14,32894,94158,94158,0.34935,64252,29906,2.148465191
6796,SS6004480,15,29434,83591,83591,0.35212,56825,26766,2.123029216
6797,SS6004480,16,28860,87081,87081,0.33142,56899,30182,1.885196475
6798,SS6004480,17,23259,71761,71761,0.32412,50592,21169,2.389909774
6799,SS6004480,18,27969,84081,84081,0.33264,57723,26358,2.189961302
6800,SS6004480,19,18115,51885,51885,0.34914,36626,15259,2.400288354
6801,SS6004480,2,82979,244394,244394,0.33953,165850,78544,2.111555307
6802,SS6004480,20,21475,64963,64963,0.33057,45348,19615,2.311904155
6803,SS6004480,21,14679,42260,42260,0.34735,29032,13228,2.194738434
6804,SS6004480,22,11897,36479,36479,0.32613,25781,10698,2.409889699
6805,SS6004480,3,72258,211437,211437,0.34175,142853,68584,2.082891053
6806,SS6004480,4,73594,209566,209566,0.35117,141389,68177,2.073851886
6807,SS6004480,5,61538,186022,186022,0.33081,125735,60287,2.085607179
6808,SS6004480,6,62112,185868,185868,0.33417,127332,58536,2.175276753
6809,SS6004480,7,56926,159452,159452,0.35701,108210,51242,2.111744272
6810,SS6004480,8,54165,159924,159924,0.33869,106036,53888,1.967710808
6811,SS6004480,9,42049,120560,120560,0.34878,80675,39885,2.022690234
6812,SS6004480,MT,83,84,84,0.9881,81,3,27
6813,SS6004480,X,69308,70732,70732,0.97987,47255,23477,2.012821059
6814,SS6004480,Y,1609,1655,1655,0.97221,1044,611,1.708674304
